a bamboo carrying pole	đòn ống	
a bleached jacket	cái áo bạc phếch	
a bottle of whisky	một chai huýt ky	
a chalky complexion	nước da bệch	
a closing ceremony	lễ bế mạc	
a cooking pot for ten men	nồi mười	
a crack artist	nghệ sĩ nhà nòi	
a curse	một tiếng chửi thề	
a day will come (when)	sẽ có một ngày	
a different (kind of) person	một con người khác	
a dull yellow complexion	nước da vàng ệnh	
a fervid soul	tâm hồn nồng cháy	
a few days	ít hôm	
a few minutes	mấy phút	
a few more steps	vài bước nữa	
a few weeks	mấy tuần	
a few years ago	cách đây vài năm	
a flock of grandchildren	đàn cháu	
a flower	một đóa hoa	
a gate keeper	người gác cửa	
a glass of foaming beer	cốc bia nổi bọt	
a glossy table top	mặt bàn nhẵn bóng	
a good sign	một dấu hiệu tốt	
a great	thành công rất đáng kể	
a group of clouds	áng mây	
a gun	một cây súng	
a half-baked physician	thầy thuốc nửa mùa	
a hanging stroke (calligraphy)	nét sổ	
a hell of a	bỏ bố	
a historical event	một sự kiện lịch sử	
a hole big enough for a person to fit through	một lỗ người chui lọt	
a jealous woman	đố phụ	
a kind of rice cake	xu xê	
a knowledge of English	hiểu biết về Ang ngữ	
a large sum of money	một số tiền không lồ	
a life worth living	cuộc đời đáng sống	
a little	ít nhiều	
a little chilly	lành lạnh	
a little familiar	quen quen	
a little shy	thèn thẹn	
a lively debate	cuộc tranh luận sôi nổi	
a long time ago (10000 years)	ngàn đời	
a low	nhà lụp xụp	
a man of a firm stuff	người có bản lãnh cao cường	
a moment ago	lúc nãy	
a mother that takes a loving care of her baby	mẹ nâng niu con	
a musical note	xang	
a newly introduced plant	cây mới nhập nội	
a number of	một số các	
a part	di tích lịch sử	
a pen rest	bút giá	
a person who is at home anywhere he goes	bốn bể là nhà	
a petrol tank	bể xăng	
a piece of advice	một lời khuyên	
a piece of poetry	bài văn	
a pile of sand	một đống cát	
a plan	một kế	
a plump person	người béo múp	
a poor	tình trạng èo uột	
a prominent Adam’s apple	lộ hầu	
a race of oxen	nòi bò	
a rectangle’s surface	bề mặt hình chữ nhựt	
a reprinted and revised book	sách in lại khó khảo đính	
a royal bed	giường ngự	
a Russian textbook	sách dạy nga văn	
a savage action	hành động dã man	
a set	một sỗ bài	
a short time thereafter	một thời gian ngắn sau khi	
a small basket or rice	mủng gạo	
a square face	mặt chữ điền	
a step	một bước	
a straight nose	mũi dọc dừa	
a strong military	một quân lực hùng mạnh	
a tactical withdrawal	một vụ rút lui chiến thuật	
a telephone conversation	một cuộc nói chuyện qua điện thoại	
a thousand leagues	nghìn trùng	
a tune	xoang điệu	
a vague answer	ứ hự	
a very awkward situation	kinh nghiệm rất thô thiển	
a very powerful person	người rất có thế lực	
a visit	viếng thăm	
a voice that cannot be silenced	tiếng không át được	
a year and a half old	một tuổi rưỡi	
a zigzagging flash of lightning	chớp ngoằn ngoèo	
abate (said of a fit of fever)	cất cơn	
abbreviated as	viết tắt là	
able	có chức năng	
abode	gia cư	
about to cry	sắp khóc	
about two o’clock	độ hai giờ	
absent	khiếm diện	
absently	trong mơ màng	
absolute monarchy	quân chủ chuyên chế	
absolutely essential	tuyệt đối cốt yếu	
absolve somebody’s sin	chiêu tuyết	
abundance	phong doanh	
academic title	học vị	
academy	hàn lâm	
accept	chuẩn nhận	
accession	tăng sản	
accomplice	đồ đảng	
accord	hợp âm	
according to calculations	theo tính toán	
according to news sources	theo các nguồn tin	
according to reports	theo báo cáo	
according to the new agreement	chiếu theo thỏa hiệp mới	
account	trương mục	
account number	số trương mục	
accusation	lời cáo giác	
acetylene	a cê ti len	
Achilles	Ác Xiên Luận	
acid rain	mưa axít	
acoustics	thanh học	
acrid	chát	
across the street	bên kia đường	
act according to circumstances	kinh quyền	
acting pope	Quyền Giáo Tông	
action and reaction	tác dụng và phản kháng	
active element	hoạt chất	
actual situation (state)	thực trạng	
addicted to marijuana	nghiện cần sa	
address	chỗ ở	
addressing	định địa chỉ	
adequate	tương xứng	
adjacent	vùng lân cận	
adjacent house	nhà bên cạnh	
administrative committee	ủy ban hành chính	
administrative method	phương pháp cai trị	
admiral	thủy sư đô đốc	
admire and esteem	cảm mến	
adoptive mother	dưỡng mẫu	
adulterer	gian phu	
advanced in years	có tuổi	
adverb	trạng từ	
adversary	thù địch	
adversity	nghịch cảnh	
advise	khuyên lơn	
advisory council	hội đồng tư vấn	
aerolite	thiên thạch	
affable	hòa uyển	
affection and gratitude	tình nghĩa	
aforementioned	vừa kể trên	
Africa	châu Phi	
after (an event)	sau dịp	
after which	rồi sau đó	
afternoon	ban chiều	
against	lại	
against somebody’s will	trái ý	
age	niên đại	
agent	tay sai	
aggressive	hùnh hổ	
Agnus castus	cây trinh nữ	
agricultural plants	cây nông nghiệp	
agriculture	canh nông	
aid	cứu tế	
ailing	ốm o	
air alert	báo đông ứng trực trên không	
air pressure	áp suất khí quyển	
air strike	không tập	
air-conditioner	máy điều hòa không khí	
airfield	trường bay	
airplane engine	động cơ máy bay	
airspace	không nhận	
albino	bạch tạng	
alcohol	rượu cồn	
alert	a léc	
aliphatic or fatty acid	a xít béo	
alkalimeter	kiềm kế	
all Americans	toàn dân Mỹ	
all gone	trọi lỏi	
all kinds of things	đủ các thứ tiết mục	
all of us	toàn thể chúng ta đều	
all over the city	khắp thành phố	
all reporting the same	chúng khẩu đồng từ	
all the more	phương chi	
all the way in England	ở tận Anh Quốc	
all trades	bách công	
alligator skin	da cá sấu	
allowance	cấp khoản	
all-powerful	toàn năng	
almost	cơ hồ	
almost all ~ are	hầu hết ~ đều là	
almost completely	gần như trọn vẹn	
almost everything	hầu như gần hết	
alphabet	an pha bê	
already	rồi	
also called	còn được gọi tắt là	
alum	phèn	
alveolar	nha oa âm	
alveolar-dental sound	âm răng nứu	
ambiguity	ám nghĩa	
ambitious	vị danh	
ambulance	chiếc xe cứu thương	
Amer-Asian	con lai Mỹ	
American (person)	người Mỹ	
American soldier	lính Mỹ	
amicable	ổn thoả	
amniotic fluid	all over	nước ối
amorfophallus	khoai nưa	
amount of time	thời lượng	
ample	thịnh soạn	
amuse oneself (without) doing anything)	chơi nhởn	
an ally	một người đồng minh	
an armed man	người đàn ông vũ trang	
an attractive man	nam nhân hấp dẫn	
an elder	đại lão	
an enduring struggle	cuộc đấu tranh bền bỉ	
an exchange	sự trao đổi	
an hour later	tiếng đồng hồ sau đó	
an immanent cause	nguyên nhân nội tại	
an important thing to remember is ~	một điều quan trọng nên nhớ là	
an issue of race	đề tài về sắc dân	
an old hag of a woman	con mụ khó tính	
an oppressive atmosphere	không khí nghẹt thở	
an unfavorable turn in the situation	tình hình phát triển một cách bất lợi	
an unjust attitude	thái độ bất công	
an unruly little boy	thằng bé bất trị	
anaesthetize	đánh thuốc mê	
analogy	loại suy	
ancestors	thế tổ	
ancient	cổ kính	
ancient civilization	văn hiến cổ	
ancient military officers’ tigerhead-shaped seal	hổ phù	
and one more thing	và thêm một cái	
and that's not all	chưa hết	
anemic	thiếu máu	
angelica	bạch chỉ	
angle	khía	
animal husbandry products	súc sản	
Annam	nước An Nam	
annihilating attack	đánh tiêu diệt	
annotation	tiểu chú	
annuity	niên kim	
another day	hôm khác	
answer	câu trả lời	
antenna	ăng ten	
antenna tuning	điều hợp ăng ten	
anthropology	nhân chủng học	
antiaircraft missile	tên lửa phòng không	
anticommunist	phản cộng	
anticyclone	xoáy nghịch	
antipathy	ác cảm	
antipopular	phản dân hại nước	
antiques	cổ vật	
antiviral	kháng vi rút	
antler glue	cao ban long	
any (at all)	bất cứ	
anything (at all)	bất cứ điều gì	
aperture	khẩu độ	
appearance	mẽ	
appendage	phần phụ	
applicant	thí sinh	
apply oneself to	gia tâm	
appoint one’s heir	lập tự	
appropriate	phải chăng	
approximately	khoảng gần	
arc suppression coil	cuộn dập hồ quang	
arch of heaven	vòm trời	
archeozoic	thái cổ	
architecture	cấu trúc	
archivist (Cao Dai)	Sĩ Tải	
ardent and deep-felt (of sentiments)	nồng đượm	
ardor	sự hăng say	
areca banana (a kind of banana)	chuối cau	
Arhat	La Hán	
arithmetic operation-mathematical problem	con tính	
arm	sách tay	
armed security (staff)	nhân viên an ninh vũ trang	
army	binh mã	
army law	quân pháp	
aromatic substance	chất thơm	
around New Year’s	dạo Tết	
arrive late	đến trễ	
arrow	thỉ	
arsenal	binh khố	
art gallery	ga lơ ri	
arthopod	chân khớp	
articulate	cấu âm	
artificial hair	tóc giả	
artistic talent	tài nghệ	
arts and crafts	mỹ thuật công nghiệp	
as a dead as a doornail	chết đứ đừ	
as a result	da đó	
as for him/you	phần ông	
as God is my witness	xin trời đất tha thứ cho tôi	
as I said before	như đã nói	
as it is often called	như thường được gọi	
as much as now	cho bằng lúc này	
as sure as	hễ mà	
as we have already seen	như chúng ta đã thấy	
as well as	cũng như	
asexual reproduction	sinh sản vô tính	
Asia	Châu Á	
ask (pupils) questions on a lesson	hỏi bài	
aspect	cạnh khía	
assail (ply) (somebody) with questions	hỏi dồn	
assembly hall	lễ đường	
assess or estimate one’s strength	tự lượng	
assessor	phụ thẩm	
assist in disaster	phù nguy	
assistant envoy	phó sứ	
asthma	hen suyễn	
astrologer	nhà chiêm tinh học	
astronomer	nhà thiên văn	
asymptotic	tiệm cận	
at (the) least	bét ra	
at a wage of	với giá lương	
at an early date	vào một ngày gần đây	
at any price	bằng mọi giá	
at every	trong mọi tầng lớp	
at first strange	trước lạ sau quen	
at large	tại đào	
at least	ít ra	
at one’s waist	trong bụng	
at that time	bấy giờ	
at the beginning of (a period of time)	vào đầu	
at the beginning of this century	vào đầu thế kỷ này	
at the end of the day	vào cuối ngày	
at the operating system level	ở mức hệ điều hành	
at the present time	trong thời gian hiện nay	
at the same time	cùng lúc đó	
at thirty	tam thập nhi lập	
at will	tùy thích	
atheroma	vữa động mạch	
atomic	gia đình hạt nhân	
Atoms for Peace project	chương trình Nguyên Tử Phục Vụ Hòa Bình	
atrophia cutis	teo da	
attached to	lưu luyến	
attempt	sự cố gắng	
attractively tawny	đen giòn	
auction room	tầm tầm	
audiogram	thính lực đồ	
August	tháng tám	
aunts (mother’s and father’s side)	cô dì	
Austria	Áo Quốc	
authoritarian	bá đạo	
authorized dealer (of a product)	đại diện chính thức	
auto	ô-tô	
autocar	ô tô ca	
automatic proof	chứng minh tự động	
automobile accident	vụ xe đụng	
autonomous area	khu tự trị	
autopsy	sự mổ xác	
autumnal cold breeze	gió heo may	
availability	khả năng huy động	
average height	có chiều cao trung bình	
aviation	hàng không	
avoid	bán mặt	
awful	ghê	
awning	ô văng	
babies	anh nhi	
bachang mango	quéo	
back pain	đau lưng	
backscratcher	cái gãi lưng	
bacteriology	vi khuẩn học	
bad custom	tệ tục	
bad news	hung tin	
bad tactics	thất sách	
bad-smelling	tanh hôi	
baggage horse	ngựa thồ	
baked meat	thịt nướng	
bald hill	đồi trọc	
ball games	đấu bóng	
balloon	khinh khí cầu	
Balsam-apple	mướp đắng	
bamboo door	cửa liếp	
bamboo mat	cót	
bamboo screen	liếp	
bamboo tree	bụi tre	
bamboo-plaited dustpan	ky	
banana flower	bắp chuối	
band	nậu	
Bangkok	Băng Cốc	
bank deposit	ký thác ngân hàng	
bank teller	thư ký ngân hàng	
bar (unit of pressure)	đơn vị áp suất	
barbarous	man rợ	
bare	trần trụi	
baritone	nam trung	
barley	đại mạch	
barometer	khí áp kế	
barricade	chướng ngại vật	
basalt	ba zan	
bascule balance	cân bàn	
based on	dựa trên căn bản	
basic element	yếu tố căn bản	
basic military training	huấn luyện quân sự căn bản	
basil	húng quế	
bassia	sến	
bathroom	nhà tắm	
batten	mè	
battle cruiser	tuần dương hạm chiến đấu	
be a little frightened	trờn trợn	
be absent-minded	chầu hẫu	
be affected by diabetes	đái tháo	
be angered	tức khí	
be aroused	giậm giật	
be attached	phối thuộc	
be awake	thức nhắc	
be beaming (swollen) with pride	nở mũi	
be blown or puffed up	phổng	
be careful	liệu hồn	
be cold with fear	lạnh gáy	
be confined	nằm bếp	
be deported	đi đày	
be engaged to each other	đính ước	
be exiled and made a border guard	sung quân	
be first to propose	đề khởi	
be fully satisfied	hởi lòng hởi dạ	
be in for	một mẻ	
be jealous (in love)	ghen tuông	
be moved	mủi lòng	
be of great wisdom	túc trí đa mưu	
be parsimonious	dè sẻn	
be pervaded with	nức	
be pregnant	ôm trống	
be quite green	rờn	
be satisfied	khoái ý	
be smooth-tongued	nói mép	
be under police surveillance	bị công an rình rập	
be upset	rộn rực	
be very sleepy (with eyelids being too heavy)	ríu mắt	
be wide open	tếch toác	
be without off spring	mất giống	
bean cake	bã đậu	
beard	râu cẳm	
beasts and birds	muông chim	
beat up	già đòn	
beautiful and graceful	uyển nhã	
beautiful face	ngọc diện	
beautiful love history	diễm sử	
beautiful woman’s sleep	giấc tiên	
beauty queen	hoa hậu	
because of (this)	di vậy	
become a genie	hiển thánh	
become repentant	quy chính	
beef dumpling	giò bò	
beer and wine	bia rượu	
before and after	trước sau	
before the world	trước thế giới	
beg	ngửa tay	
begin	khai thủy	
begin to open	hàm tiếu	
beginning course	nhập môn	
beginning on Sunday	khởi sự từ hôm chủ nhật	
behave in a ridiculously domineering way	nhắng	
behave well in society	ứng thù	
behind	ở sau	
behind the house	sau nhà	
being nothing but skin and bone	da bọc xương	
belief	lòng tin	
believe firmly	thành tín	
believer (religious)	tín hữu	
beloved daughter	con gái rượu	
benefactor	ân nhân	
benevolence	dư ân	
benevolent association	hội hợp thiện	
beriberi	cước khí	
beseech attention and granting of one’s wish	kêu xin	
bestowed by royal decree	sắc tứ	
betel	trầu	
between	ở giữa	
beyond all	hoàn toàn ngoài mọi	
bib	yếm dãi	
bide one’s time	đợi thời	
big ant	kiến càng	
big character	đại tự	
big feast	mâm cao cỗ đầy	
big waves	sóng đào	
biggest of a flock (herd)	đầu đàn	
bilateral trade	mậu dịch song phương	
billfold	ví tiền	
bimonthly	bán nguyệt	
binding	kết ghép	
bioavailability	khả dụng sinh học	
biosynthesis	sinh tổng hợp	
biquadratic	trùng phương	
birth certificate	giấy khai sinh	
bisexual	lại cái	
bizarre	kỳ quái	
black and blue	bầm	
black box	hộp đen	
black carp	cá trắm đen	
black hair	tóc đen	
black market economy	kinh tế chợ đen	
black sheep	con chiên ghẻ	
bladder	bàng quang	
blain	mụn rộp	
blastula	phôi nang	
blessing	phúc đức	
blind ditch	hầm chông	
blisteringly	nắng ác	
blood	máu	
blood and bones	máu xương	
blood debt	nợ máu	
bloodstain	vết máu	
bloody road	huyết lộ	
blow gently	hiu hắt	
blue blood	nhà nòi	
blue-bottle	ruồi xanh	
blush	ửng đỏ	
board of directors	ban giám đốc	
boarding-house	nhà trọ	
boat	chiếc tàu thủy	
bodhi (tree)	bồ đề	
body	hình hài	
body and soul	thể phách	
bog	bãi lầy	
boil (on skin)	nhọt	
boil with anger	sôi ruột	
boiling hot food	thức ăn nóng sốt	
bold-faced	vô liêm sỉ	
bolster	gối dựa	
bomber (plane)	chiếc oanh tạc	
bone(s)	xương cốt	
bonus	bổng ngoại	
book of ancient histories	cổ lục	
books	sổ sách	
bookshelf	giá sách	
bookworm	mọt sách	
boot	giày bốt	
border area	vùng biên giới	
bored	chán ngán	
borrow	hỏi mượn	
bosom or sworn friend	chí cốt	
both complete	song toàn	
both delegations	hai phái đoàn	
both sides	cả hai bên	
bottles	ve chai	
bouquet (of flowers)	bó hoa	
bow and arrows	cung tên	
bowel of horse	ruột ngựa	
bowl	đọi	
box barrage	bắn bao vây	
boy	cậu bé	
brag	trém	
brain surgery	giải phẫu não	
brain-wash	tẩy não	
branch (of a tree)	cành cây	
branches and leaves	cành lá	
brassy	chói tai	
Brazil	Brazin	
bread flour	bột bánh mì	
break	đánh bể	
bream	cá vền	
breeding facilities	chuồng trại	
bribery	vụ hối lộ	
bride’s family-bride’s guest	nhà gái	
bright (light)	sáng choang	
brightly lit	choang	
brimming over	chan chan	
brisket	nầm	
broad daylight	bạch nhật	
brocade	gấm thêu	
broken piece of a bowl	mảnh bát	
bronchus	cuống phổi	
brooch	trâm	
brother in law (wife’s older brother)	anh vợ	
brothers and sisters	anh em chị em	
brothers of the same family	sân hòe	
brown bear	gấu nâu	
brown tea	chè mạn	
brownish	da lươn	
brush	bàn chải	
bubble	sủi tăm	
bucket with a long handle	gàu ròng	
bud	búp	
Buddhist	tín đồ Phật Giáo	
Buddhist nun	bà vãi	
Buddhist scripture	kinh Phật	
buffalo-calf liver extract	ngưu hoàng	
bug	rệp	
Bulgaria	Bảo Gia Lợi	
bulging eyes	mắt ốc nhồi	
bullage	mận rừng	
bullfrog	ĩnh ương	
bumpy	kỳ khu	
bungled	lam nham	
burgher	thị dân	
burn	chỗ bỏng	
burn up completely	cháy trụi	
burst noisily and loudly into angry words	gắt mù	
bus	bu‎ýt	
bush-bean	đậu trắng	
business card	danh thiếp	
business establishment	cơ sở kinh doanh	
business man	người nhà kinh doanh	
businessman	nhà buôn	
but fortunately	nhưng may quá	
butter	quản gia	
buxom	phôm phốp	
by chance	khi không	
by land	đường bộ	
by-product	phụ phẩm	
cage-bird	chim lồng	
calculated	thành toán	
caliber	tầm cỡ	
call by reference	gọi theo tham khảo	
callous	cương cường	
calyx	đài hoa	
camelia	hoa trà	
campaign	chiến dịch	
camp-bed	ghế bố	
camphor oil	dầu chổi	
can	được	
can occur	có thể xảy ra	
can of paint	bình sơn	
cancer	ung thư	
cane-juice	nước mía	
cannot help	không khỏi	
canon	kinh điển	
canteen	bi đông	
cantonal schoolmaster	tổng sư	
Cantonese (language)	tiếng quản đông	
capabilities	bản lãnh	
capacitor	tụ điện	
capital	chân lưng	
capital city	kinh thành	
capital crime	tội chết	
capitalist	nhà tư bản	
capsule	bọc nhện	
car payment	tiền xe	
care	mối lo	
carefree	vô tư lự	
cargo	tàu chuyên chở	
carrot	ca rốt	
carry on one’s shoulders (on one’s back)	khiêng vác	
cartilage	sụn	
case	cái vụ	
cash balance	tồn quỹ	
cash on delivery	tiền trao cháo múc	
cassia grandis	and ginger	
cast (a play)	phân vai	
castor oil	dầu thầu dầu	
catafalque	nhà táng	
catapult	ná cao su	
catch a glimpse of	nhác thấy	
caterpillar	bọ nẹt	
cattle egret	cò ruồi	
Caucasian	da trắng	
causality	quan hệ nhân quả	
cause of an illness	căn bệnh	
CD (compact disks)	đĩa CD	
celery	cần tây	
celestial court	thiên đình	
cell	xà lim	
cell (of a bonze)	phương trượng	
cellular division	phân bào	
cemetery	bãi tha ma	
cent	xu	
centimeter	centimet	
Central America	Trung Mỹ	
central processing unit	bộ xử lí trung ương	
ceramic tile	gạch tráng men	
cerebellum	tiểu não	
certainly not	chắc chắn là không	
certificate	giấy chứng chỉ	
chain	cùm	
chamber of commerce	thương hội	
championship	giải vô địch	
chance (kind of venereal disease)	hột xoài	
change the member of an equation	chuyển vế	
chant	bản hát	
chap	gã	
character set	bảng mã tự	
charge sheet	bản cáo trạng	
charitable Buddhist believer	đàn việt	
charm	bùa mê	
chassis	khung gầm	
check your wallet (for money)	nắn lưng	
cheese	phô mai	
chemical formula	công thức hóa học	
chemical substance	hóa chất	
cherry	anh đào	
chest	lồng ngực	
chicken	con gà	
chicken wing	cáng gà	
chief	chúa tể	
chief envoy (of a feudal mission)	chánh sứ	
chief town	lỵ sở	
child of one’s son	cháu nội	
children’s book	sách nhi đồng	
children’s toy	tò he	
China	Trung Hoa	
Chinese (language)	tiếng Hoa	
Chinese character	Hán tụ	
chinese laughing-thrush (chim)	khướu	
Chinese melon	dưa hồng	
Chinese translation	bản dịch Hán	
chipped	sứt	
chlorophyll	diệp lục	
chord	hòa âm	
Christian	Kitô hữu	
chromatic scale	bán âm giai	
chromosome	nhiễm thể	
cigarette	điếu thuốc lá	
cigarette-holder	đót	
circle	hình tròn	
circular telegram	thông điện	
citizen	dân	
city hall	tòa thị chính	
city unit	thành đội	
civil and military	văn võ	
civil education	công dân giáo dục	
civil rights organization	cơ quan công quyền	
civilian career	nghề văn	
clam	sò	
clan	thị tộc	
clank	ọt ẹt	
clap clap	rôm rốp	
clarinet	cla ri nét	
class	lứa	
classical period	cổ đại	
classify	phân hạng	
classroom	lớp học	
clavicle	xương đòn gánh	
claws	móng vuốt	
clean and decorate the ancestral graves	tảo mộ	
clear one’s throat	dặng	
clear purple	tim tím	
clear water	thanh thủy	
clergy	tăng lữ	
clerical worker	nhân viên văn thư	
cliché	sáo ngữ	
cliff	vách đá	
clinch-nail	đinh mũ	
clink glasses	chạm cốc	
clique	bè cánh	
clomax	cao đỉnh	
close	khít khao	
close friend	khách tri âm	
closet	tủ quần áo	
closing cost (on a house)	tiền hồ sơ	
clothes	quần áo	
cloud	đám mây	
cloudy	u ám	
cloyingly sweet	ngọt sắc	
coal	than đá	
coal dust	than cám	
coat rack	giá áo	
cobalt	cô ban	
cocaine	cô ca in	
coconut	dừa	
code	mã hiệu	
code optimization	tối ưu mã	
coerce	o ép	
coffin shop	nhà đòn	
coincidental	sự ngẫu nhiên	
cold patching (tires)	vá sống	
cold water	nước lạnh	
collapse	băng hoại	
colleague	bạn đồn liêu	
collection of selected poems	nhã tập	
collective	tập thể	
collide	cụng	
colloquial	thường đàm	
colonial regime	chế độ thực dân	
colored person	thằng da màu	
column	chuyên mục	
combat unit	chiến đoàn	
comfit	kẹo hạnh nhân	
comfort is better than pride	ăn chắc mặc bền	
command	bộ chỉ huy	
commander	tướng lĩnh	
commando	biệt kích	
commerce	buôn bán	
commission	com mít xi ông	
committee	ủy ban	
common agreement	thỏa thuận chung	
common divisor	ước số chung	
common food	đại táo	
common language	ngôn ngữ chung	
common word	chữ thông dụng	
communal	cộng đồng tài sản	
commune	xã thôn	
communications are not convenient	đường sá bất tiện	
communist bandits	cộng phi	
communist party member	đảng viên Cộng sản	
Communist Vietnamese Government	chế độ CSVN	
compact disk	đĩa nhỏ	
companion-in-arms	bạn chiến đấu	
company	công tu	
compared to (the same period) last year	so với cùng ỳ năm ngoái	
compatible (with)	tương thích	
compensatory fund	quỹ bù trừ	
competence	chức quyền	
competitive price	giá cạnh tranh	
complain angrilly	oán trách	
complete	vẹn tuyền	
complete works	toàn tập	
completely dark	tối mịt	
completely empty	sạch sành sanh	
completely ignorant	mít đặc	
completely unaware	mù tịt	
complicate matters	bày trò	
complicated problem	vấn đề rắc rối	
complication(s)	thứ rắc rối	
composition	bài luận	
compound word	chữ ghép	
comprising	gồm có	
computer control system	hệ thống điều khiển máy tính	
computer network	mạng lưới điện toán	
computer system	hệ thống điện toán	
computing power	năng lực tính toán	
comrade-in-arms	chiến hữu	
concession	tô nhượng	
conclusive evidence	xác chứng	
concrete beam bridge	cầu đá bê tông	
concrete slab bridge	cầu lát bê tông	
concubine	cát lũy	
condense	ngưng kết	
condescending	trịnh thượng	
conditional sale	bán đợ	
conditions threatened rain	vần vũ	
confectionary	bánh kẹo	
confess one’s sin	xưng tội	
confident	vững dạ	
confidential report	mật báo	
configuration	cấu hình	
confluence	hợp lưu	
Confucianism	Khổng giáo	
confused noise	eo óc	
conifers	tùng bách	
conjure up a deal person’s soul	gọi hồn	
connection	rắc co	
connection procedure	thủ tục kết nối	
conscience	lương thần	
consciousness	tâm thức	
consent (to something)	âu đành	
conservatory	nhạc viện	
consistence	nhất quán	
Con-Son (island)	Côn Sơn	
consortium	công xoóc xi om	
constipated	táo kiết	
constitution	tạng khí	
constrain (to follow some rule of behavior)	gò ép	
contented	mát mặt	
continual	miên man	
continued on	xem tiếp	
continuous	liên tiếp	
contraband goods	hàng lậu	
contraindication	chống chỉ định	
contrary to	ngược với	
contrivance	gá lắp	
control	việc kiểm soát	
control process	quy trình điều độ	
convention	công ước	
conventional sign	thông hiệu	
converse	phản đề	
convertible car	xe sập mui	
convolution	khúc cuộn	
convoy	công voa	
coolie	dân phu	
coordinator	điều phối viên	
copy from the original	sao lục	
core	cốt lõi	
co-religionist	đồng đạo	
corn	bắp ngô	
cornel-tree	thù du	
corner of the eye canthus	khóe hạnh	
corporal punishment	nhục hình	
corpse	cái xác	
correct saying	chính ngôn	
corrugated steel	tôn dợn sóng	
corsair	Tàu ô	
cosmetics	phấn sáp	
cost of labor	giá nhân công	
costume (of actors)	phục trang	
cotangent	cô tang	
coughing fit	cơn ho	
council	hội đồng	
count on one’s power	ỷ thế	
countercheck	phản nghiệm	
counterfeit money	bạc giả	
counter-propaganda	phản tuyên truyền	
country area	vùng nhà quê	
coupled lens	thấu kính ghép	
courage	dũng khí	
court (royal	triều	
court order	án lệnh	
court usher	mõ tòa	
courtiers	đình thần	
cover a large extent of earth (with flags)	rợp đất	
cow buffalo	trâu nái	
cowling	ca pô	
cracked	cám hấp	
crafty	quỉ quyệt	
cramp	chuột rút	
crazy	khùng điên	
creaking sound	kẽo cà kẽo kẹt	
creative work	tác phẩm	
crèche	dục anh đường	
credit bureau	báo cáo lý lịch tím dụng	
credulous	cả tin	
crescent moon	trăng khuyết	
crevice	kẽ nẻ	
crime against humanity	tội ác chống nhân loại	
criminal case	hình án	
criminal nature	tội phạm nguy hiểm	
crisp noise	rau ráu	
criteria	định chế	
critical study	bị khảo	
crook	đồ ba que	
crooked throat (injury)	trẹo họng	
cross section	lát cắt qua	
crowd control	kiểm soát đám đông	
crown	mũ miện	
cruel	cay nghiệt	
crushed	bẹp	
cryptography	an ninh mật mã	
crystallography	kết tinh học	
cuckoo	cu cu	
cudweed	rau khúc	
cultivate	tài bồi	
cultural legacy	di sản văn học	
cunning	cáo già	
cup (used in medicine)	bầu giác	
cupboard	búp phê	
cupped	loe	
curly	loăn xoăn	
current (at present)	hiện có	
current transformer	biến dòng điện	
cursory	hời hợt	
curved	cong	
custom-made	may đo	
cut into pieces	cắt khúc	
cut off	cụt	
cut the inauguration band	cắt băng	
cutoff frequency	tần số cắt	
cycad	thiên tuế	
cylindrical glutinous rice cake	bánh tét	
cymbals	não bạt	
cyst	u nang	
Da river	sông Đà	
daily	hàng ngày	
daily prayer	kinh nhật tụng	
Dalat	Ðà Lạt	
dale	sơn cốc	
damned	chó chết	
dance hall	vũ trường	
danger spot	hùng thắng	
dangerous	nguy vong	
đào tạo (training)	ĐT	
dark complexion	da bánh mật	
dark-complexioned	da dâu	
dart	phi tiêu	
data management	quản trị dữ liệu	
data structure	cấu trúc dữ liệu	
date of birth	ngày sinh tháng đẻ	
datura	cà độc dược	
daughter-in-law	nàng dâu	
day of remembrance	ngày kỷ niệm	
days of old	đời xưa	
dead at birth	chết non	
dead route	tử lộ	
deadlock	chết tắc	
deaf	điếc lác	
dealer	xóc cái	
dear	thân yêu	
dear lord	lạy chúa	
death anniversaries and festivities	giỗ tết	
death’s head	đầu lâu	
deathly pale	tái mét	
debt	nợ nần	
debtor and creditor	bên có và bên nợ	
deceive	đánh lận	
decentralization	phân quyền	
decimal (fraction)	phần lẻ	
deck of (playing) cards	một cỗ bài	
decode	dịch mã	
decomposition	phân tách	
decrease somewhat in price	nới giá	
dedication	tinh thần phục vụ	
deep	ồ ồ	
deep gratitude	thâm tạ	
deep voice	giọng ồ ề	
deep water port	cảng nước sâu	
default	mặc định	
defeated	bại vong	
defeated troops	tàn binh	
defensive	thế thủ	
deficiency	thiếu hụt men	
deflowered	thất trinh	
delay time (of a relay)	thời gian trễ	
deliberate	khoan thai	
delirious	mê hoảng	
democratic election	bầu cử dân chủ	
democratic socialist party	đảng dân chủ xã hội	
demonstration	biểu tình	
dendrobium	thạch hộc	
dendrophis	rắn lục	
department	bộ sở	
Department of Energy	Bộ Trưởng Năng Lượng	
department store	cửa hàng bách hóa	
depend on	dựa dẫm	
depend on someone for	nhờ cậy	
deposit	tiền đặt cọc	
depression	sụt lún	
deputy ambassador	phó đại sứ	
deputy director of a department	vụ phó	
deputy rector	phó viện trưởng	
deserted	hoang liêu	
design to betray	mưu phản	
desire	lòng ham thích	
desolate	thê lương	
despite	bất kể	
destiny	định mệnh	
destruction	việc tàn phá	
detachment	biệt đội	
detail(ed)	vụn vặt	
details	chi tiết	
determinant	định thức	
determinism	quyết định luận	
detonator	kíp nổ	
develop the mind	khai trí	
developed country	nước phát triển	
deviation	độ sai lệch	
devour	ngấu nghiến	
dewing	khâu vá	
diagnosis	định bệnh	
dialectic materialism	duy vật biên chứng	
diamagnetic substance	chất nghịch từ	
dictation	ám tả	
dictatorial system	thể chế độc tài	
die	tào cáo	
diesel	đi ê zen	
different from the last time	khác với lần trước	
differential calculus	phép tính vi phân	
differential spider pinion	bánh xe vệ tinh	
difficiency	sự thiếu xót	
difficult respiration	đoản hơi	
difficulty	cái khó	
dihedral	nhị diện	
dilly-dally	nhùng nhằng	
dim light	ánh sáng mờ mờ	
ding-dong	leng keng	
diode	đèn hai cực	
diplomatic breakthrough	đột phá ngoại giao	
direction board	bảng chỉ hướng	
directly in front of	ngay trước mặt	
dirty	bầy hầy	
dirty as a pig	bẩn như lợn	
dirty movie	phim con heo	
dirty story	chuyện con heo	
disappear	tiêu ma	
disburse	lòi tiền	
discarded	ra rìa	
discontinuous	bất liên tục	
discovery	phát hiện	
disease	bệnh	
disheveled	bờm chờm	
disk (shaped) antenna	ăng ten hình bầu dục	
dislocate (joint etc)	lọi xương	
disorderly	bộn	
disperse	tán sắc	
disposition	khí chất	
disregard the favor (done by somebody)	phủi ơn	
dissident (person)	người ly khai	
distant	cách biệt	
distill alcohol	cất rượu	
distribute fields per capita of population	quân điền	
distribution	sự phân phối	
district education officer	giáo thụ	
district political party branch	huyện bộ	
diuretic	lợi tiểu	
dividend	số bị chia	
diving suit	áo lặn	
division	phép chia	
do in a hurry	quềnh quàng	
do nothing but laugh	cười trừ	
do one’s llevel best	gắng công	
doctor (PhD)	tiến sĩ	
documentary film	phim tài liệu	
dog and horse	khuyển mã	
dogma	tín điều	
domain	phạm vi	
domestic production	sản lượng quốc nội	
don’t even (do sth)	đừng có bao giờ	
don’t go anywhere	đừng đi đâu hết	
done for	phăng teo	
doorknob	nắm cửa	
double litigation	trùng tố	
doubtful and difficult	nghi nan	
dovetail halving	ngàm	
downstream	suôi	
doze	gà gật	
dozen times	chục lần	
draft document	bản thảo tài liệu	
drag on	lẳng nhẳng	
dragonfly’s wing	cánh chuồn	
draw lots	gắp thăm	
draw to a close	đáo đầu	
drawing pin	đinh ấn	
dream	giấc mỏ	
dredger	tàu cuốc	
dried betel-nut	cau khô	
drift about	phiêu lãng	
driving wheel	bánh xe truyền sức	
drop of blood	giọt máu	
drown (as a punishment)	trôi sông	
drug addiction	nghiện ngập ma túy	
drunk	say	
drunkenness (as a problem)	nạn say rượu	
dry	cạn	
dualism	nhị nguyên luận	
duck egg	trứng vịt	
duckweed	bèo tấm	
dull	chán phè	
dumb	khờ	
dumbfounded	đớ	
dumpling	bánh bao	
dura mater	màng cứng	
during	nhân trong	
during (a period of time)	trong kỳ	
during the last few years	trong vài năm gần đây	
during the war	trong thời chiến	
during which	trong đó	
dust storm	gió bụi	
dwadling	lề mề	
dynamic type	kiểu động	
each disease has its own cure	bệnh nào thuốc nấy	
each of us	mỗi người chúng tôi	
ear and eye	nhĩ mục	
early death	yểu tử	
earn one’s living	hồ khẩu	
ear-splitting	lộng óc	
earth’s satellite	hộ tinh	
ear-wax	ráy tai	
easily-infected skin	dữ da	
east palace-crown prince’s residence-crown prince	đông cung	
easterly wind-spring wind	gió đông	
easy	dễ	
eat	lẩm	
eat with one’s front teeth	nhằn	
economic court	Tòa Kinh Tế	
economic program	chương trình kinh tế	
economic system	hệ thống kinh tế	
ecosystem	hệ sinh thái	
edge	chu vi	
edible fiber of breadfruit	xơ mít	
educated	có học	
eelworm	giun lươn	
effective drug	linh dược	
efficient (in minor jobs)	được việc	
egoism	tư tâm	
Egyptian (person)	ngơừi Ai Cập	
elastic	đàn hồi	
elder (person)	khuynh trưởng	
eldest brother	anh cả	
election	công cử	
elector chosen to elect the president	đại cử tri	
electric bus	xe buýt điện	
electric fan	quạt điện	
electrical energy	điện năng	
electrical power network	lưới điện	
Electrical Power Regulation	Luật Điện lực	
electricity purchase contract	hợp đồng mua bán điện	
electrodynamic	điện động	
electrolysis	điện phân	
electronic	điện tử	
electronics technician	cán sự điện tử	
elegant and clever	anh tú	
elegy	bi ca	
elephant	vâm	
eleven	mười mốt	
elixir of life	tiên đơn	
emaciated	rạc rài	
embalmment	ướp xác	
embarassing	đáng hổ thẹn	
embassy	đại sứ quán	
emergency pass (used by messengers carrying the king’s urgent orders)	hỏa bài	
emery	bột mài	
emetine	ê mê tin	
empty	rỗng ruột	
empty betel-nut	cau điếc	
empty vessels make most noise	thùng rỗng kêu to	
enamel	men	
encourage	tưởng lệ	
encyclopedia	bách khoa từ điển	
end of the road	hết đường	
endangered	quý hiếm	
endless (of rain)	sập sìu	
endoderm	nội nhũ	
endolymph	nội dịch	
endosmose	thẩm thấu	
endothermic reaction	phản ứng thu nhiệt	
enemy country	cừu quốc	
energy management system	hệ thống quản lý năng lượng	
engender a feud	kết oán	
engineering branch	ngành cơ khí	
English (language)	tiếng Anh	
engrave (in one’s mind)	khắc sâu	
enlightened or wise king	anh quân	
entangled	rối bòng bong	
entertainment	du hí	
entire body	toàn thân	
entire life	chung thân	
entrance examination	thi nhập học	
entrepôt	trung chuyển	
enzyme	en zim	
epilogue	lời bạt	
equal to	tày	
equerry	giám má	
equipment	trang cụ	
equipped with	có trang bị	
eraser	cục tẩy	
error	sai sót	
escalation	sự leo thang	
escort	vệ tống	
essence	nước cốt	
establish liaison	bắt liên lạc	
esteem and admire	hoài mộ	
eternal	muôn thuở	
ethics	đạo đức học	
eugenic	ưu sinh	
European (person)	người Âu châu	
European-style trousers	quần tây	
even within	ngay trong	
evening dress	văn phục	
evenings	những buổi tối	
event	biến cố	
everlasting	trường sinh	
every man for himself	mạnh ai nấy chạy	
every person	mỗi đứa	
every trick in the book	thiên mưu bách kế	
everybod	người người	
everyday use	dùng hàng ngày	
everyone is going	ai cũng đi hết	
everyone’s business	chuyện thiên hạ	
everywhere	khắp chỗ	
evolution	sự tiến hóa	
exactly like	y như	
examination	cuộc thi	
examination question	đầu đề	
excavation	việc đào đất	
exceptionally	rất mực	
excerpt from	trích từ	
excess speed	vượt tốc	
excessively	quá chừng	
exclamation mark	chấm than	
executioner	đao phủ	
exercise paper	giấy học trò	
exhausted	chồn chân mỏi gối	
exiled	biệt xứ	
existent	hiện hữu	
expect	ngõi	
expenditures	chi thu	
experience or undergo great hardships	lắng đắng	
experienced in business	quen việc	
expertly	một cách thành thạo	
explanation	sự giải thích	
explosion	vụ nổ	
explosive crater	hố nổ	
exporter	nhà xuất cảng	
expose the flank	hở sườn	
express one’s thoughts	tả tình	
expression	mặt mày	
external dimensions	hình thức bề ngoài	
extort money	khảo của	
extract the root (of a number)	khai căn	
extremely	hết sức	
extremely sad	buồn teo	
eye socket	ổ mắt	
eyelashes	lông mi	
eyepiece	thị kính	
face the enemy	nghinh địch	
facial features	nét mặt	
factor	thừa số	
failure	sự thất bại	
fair maid	phù dung	
fairy feet	gót tiền	
fairy-land	dao trì	
faithful widow	tiết phụ	
fall flat on one’s face	ngã sấp	
fall on one’s back	lăn quay	
fall to pieces	đổ nát	
falling into ruin	điêu tàn	
fallow field	thảo Điền	
false tooth	răng giả	
family	gia tộc	
family and name	tính danh	
family court	tòa án gia đình	
family register	gia phổ	
family tree	tông chi	
famous general	danh tướng	
famous singer	danh ca	
far behind	thưa xa	
farmer	nông dân	
farming calendar	nông lịch	
farther	xa hơn	
fashionable and wealthy young people	nam thanh nữ tú	
fast-acting speed regulator	bộ điều tốc tác động nhanh	
fat and clumsy	phục phịch	
fatal illness	bạo bệnh	
father and mother	ba má	
father’s concubine	dì hai	
father-in-law	trượng nhân	
fatigued	xờ xạc	
fault	đứt gãy	
favorable	thuận	
fax	điện thư	
feasibility study	nghiên cứu khả thi	
feather hat	nón lông	
feature	tính năng	
federal authorities	nhà chức trách liên bang	
federal judge	chánh án liên bang	
Federal Reserve	Cục Dự trữ Liên bang	
feel cheap	thẹn mặt	
feel rested (as from stretching one’s legs or lying down)	giản xương	
feel sleepy	buồn ngủ	
feel the urge of doing something	ngứa tay	
feeling of gratitude	ân tình	
feeling(s)	cảm xúc	
fellow man	đồng loại	
fellow-worker	cộng sự	
female	mèo cái	
female guerilla	nữ du kích	
fermented pork roll	nem chua	
ferocious	hung dữ	
ferry (landing)	bến phà	
festive	tưng bừng	
feud	tư thù	
feudal provincial judge in charge of criminal cases	án sát	
fiber	dây	
field bag	ba lô	
field dam	bờ thửa	
field maintenance	bảo trì dã chiến	
fiendishly cunning	giảo hoạt	
fierce struggle	trận đánh ác	
fifteen	mười lăm	
fifty (i.e. five tens)	năm chục	
fight against drought	chống hạn	
figure	hình dáng	
file	tập tin	
filial piety and conjugal love	hiếu tình	
fillet	thịt thăn	
filterable	qua lọc	
filter-paper	giấy lọc	
final examination	chung khảo	
final resting place	nơi an nghĩ cuối cùng	
finally	rốt cuộc	
financial market	thị trường tài chánh	
financial services	dịch vụ tài chánh	
fine	hoa mỹ	
fine arts	mỹ nghệ	
finish it!	làm nốt đi	
fire	lửa	
fire engine	xe chữa lửa	
firearm	súng ống	
fire-irons	que chọc lò	
fireman’s hose	bơm vòi rồng	
fire-prevention	phòng cháy	
fireworks	pháo bông	
firing range	tầm súng	
firing-pin	kim hỏa	
firmament	thiên không	
first	thứ thất	
first born child	con trưởng	
first laureate in national competition-examination	khôi giáp	
first love	mối tình đầu	
first of the prince	thái phó	
first ten days of a month	thượng tuần	
first-class	nhất đẳng	
fiscal cliff	bờ vực tài chính	
fiscal year	năm ngân sách	
fisher family	ngư hộ	
fishing boat	thuyền chài	
fishing rights	quyền đánh cá	
fit	vừa tay	
fit of nausea	cơn nôn ọe	
five	ngũ	
five of two	hai giờ thiếu năm	
fix a price	đặt giá	
fixed capital	tư bản cố định	
fixed point	dấu phảy tĩnh	
flag	cờ xí	
flag rules	kỳ luật	
flagrant	quả tang	
flame tree	phượng vĩ	
flash	nhoáng	
flashy	lòe loẹt	
flat country	miền xuôi	
flatter	mị	
flattering	xun xoe	
flea (on a dog)	bọ chó	
fleshless fin	vây cước	
flight (of a plane)	chuyến bay	
flipperty-flopperty	lõng thõng	
floating hotel	nhà hàng nổi	
flock of chickens	đàn gà	
floor	sàn nhà	
floss	sồi	
flourescence	huỳnh quang	
flow of money	lưu lượng tiền	
flower arranging (ikebana)	nghệ thuật cắm hoa	
flower garlands and colored lanterns	hoa đăng	
flowered silk cloth	cẩm nhung	
fluent from practice	nhuần miệng	
fly into a rage	điên khùng	
flying fox (bat)	dơi quạ	
fly-swatter	vỉ ruồi	
fog	sa mù	
folding rule	thước gấp	
folk literature	văn học dân gian	
folk song contest in the countryside (between group	trống quân	
follow in one’s father’s footsteps	kế nghiệp	
following the Chinese model	theo kiểu Trung Quốc	
food money	tiền ăn uống	
food production	sản xuất thực phẩm	
foolhardy	liều lĩnh	
football season	mùa bóng	
footwear	giày dép	
for a long (period of) time	qua thời gian	
for all one is worth	chí mạng	
for each person	cho mỗi người	
for ethical	vì những lý do đạo đức	
for fun	cho vui	
for many weeks	trong nhiều tuần	
for money	vì tiền	
for psychological reasons	về mặt tâm lý	
for what purpose	với mục đích gì	
forbid killing	giới sát	
forced	gượng ép	
forced labor	sưu dịch	
forceps	cặp thai	
foreign citizen	dân ngoại quốc	
foreign investment	đầu tư nước ngoài	
foreign language proficiency	trình độ ngoại ngữ	
Foreign minister	Bộ Trưởng Bộ Ngoại Giao	
foreign tourist	du khách ngoại quốc	
forest products	lâm sản	
forever	cho đến đời đời	
foreword	lời phi lộ	
forgetful	hay quên	
forlorn	buồn xo	
formal logic	lô gích hình thức	
formation of a company	kết xã	
former (deceased	tiên chúa	
former mayor	cựu thị trưởng	
formerly	khi trước	
fortified positions	công sự	
forty one	bốn mươi mốt	
foul	xú	
four books (ancient Chinese works)	tứ thư	
fourth place	hàng thứ tư	
fragility	sự mong manh	
frankly	của đáng tội	
freakish appearance	dị tướng	
free admission	ra vô thong thả	
free money (money that is not one’s own)	tiền chùa	
free trade	tự do mậu dịch	
freedom and democracy	dân chủ tự do	
French (not western) cuisine	cơm Tây	
French second bureau	phòng nhì	
frequency range	dải tần số	
fresh milk	sữa tươi	
fresh-water spring	cam tuyền	
friction fire-cracker	pháo xiết	
friend in old age	bạn già	
friendliness	sự thân thiện	
friendly society	ái hữu	
frightened out of one’s wits	bạt vía	
frightful	gớm ghê	
frog-bellied	bụng cóc	
from all four corners of the world	từ bốn chân trời khác nhau	
from both sides	từ hai phía	
from head to foot	từ đầu đến chân	
from inside	từ phía trong	
from now (on)	từ nay	
from one place to another	từ một nơi này qua một nơi khác	
from South to North	từ Nam chí Bắc	
from the beginning	từ ngày đầu	
from the company standpoint	từ quan điểm của công ty	
from then until now	từ đó đến nay	
from when	từ lúc nào	
front door	cửa trước	
front page (of a newspaper)	trang bìa	
front wheel drive	bánh trước phát động	
frontier passage	cửa ải	
frost	sương giá	
fruit (collectively)	trái cây	
fruits	hoa quả	
frustration	uất ẩn	
fulfill one’s duty toward one’s parents	đắc hiếu	
fulfill one’s filial duties	định tỉnh	
full of	đầy ắp	
full of customers	đông khách	
full of mosquitoes	những muỗi là muỗi	
full of vicissitudes	nổi chìm	
functional chart	biểu đồ hoạt động	
funeral ceremonies	tang sự	
fur	lông	
furrow	luống cày	
future	mai sau	
gains	lợi nhuận	
galaxy	thiên hà	
galenic physician	lương y	
gallery	phòng triển lãm	
game	cuộc vui	
gamut	thang âm	
gap between rich and poor	chênh lệch giầu nghèo	
garb	khăn áo	
garrison-cap	mũ chào mào	
gas lamp	đèn khí	
gas turbine	tua bin khí	
gasoline	xăng	
gate	cổng	
gay marriage	hôn nhân đồng tính	
genealogy	phả hệ học	
general counteroffensive	tổn phản công	
general offensive	tổng tấn công	
generation	thế hệ	
generosity	lượng cá	
genre	thể tài	
gentlemen	chư quân	
genuinely grateful	thành thật biết ơn	
geodesy	trắc địa học	
geology	địa chất học	
geometric progression	cấp số nhân	
get angry	đổ quạu	
get into trouble	phải tội	
get the upper hand (of)	hớt tay trên	
getting back to you	trở lại chuyện của mày	
giám quản	GM	
gifted	phú tính	
Gig-lamps	mục kỉch	
gingivitis	viêm nướu	
give (someone) a black look	ngấm nguýt	
give birth to and bring up	sản dục	
give extra-class help	phụ đạo	
give somebody odds	chấp bậc	
glad	vui thích	
gladiolus	la đơn	
glass of champagne	ly sâm banh	
glasses	nhãn kính	
glib	dẻo mồm	
glittering	nhoang nhoáng	
global recession	suy thoái toàn cầu	
global variable	biến toàn cục	
globalization	toàn cầu hóa	
gloss	dẫn giải	
glossy and velvety	óng mượt	
glow	ánh lửa	
gluten	nhựa bột	
glutinous rice	lúa nếp	
glutinous rice chupatty	bánh phồng	
go ahead and look	cứ coi	
go by a longer way than usual	mua đường	
go for a leisurely walk	nhàn tản	
go into the army	đầu quân	
go on foot	hành cước	
go to the railroad station	đi lại nhà ga	
goalie	thủ môn	
go-between	băng nhân	
going away party	bữa tiệc chia tay	
gold helmet	kim khôi	
golf	gôn	
good	anh em bạn	
good behaviour	dignity	
good deep	nghĩa cử	
good faith	thiện ý	
good in sciences	giỏi về khoa học	
good news	giai âm	
good point	điều thuận lợi	
good will	hội thiện nguyện	
goose grass	cỏ mần trầu	
gorged	no	
gossip	chuyện dài	
govern	trấn nhậm	
government by the people	dân trị	
government officials	các viên chức chính quyền	
grab someone by the coat’s lapel	thộp ngực	
grade	phẩm loại	
gradually	dần dần	
grains and rice	thóc gạo	
grammar drill	luyện tập nhữ pháp	
granary	vựa thóc	
grand duke	vương hầu	
grandfather	tổ phụ	
granite	hoa cương	
granular	thô hạt	
graphical environment (computer)	môi trường đồ họa	
grate	giát lò	
gravitation field	trọng trường	
gray (colored)	mầu xám	
greasy	béo ngậy	
great	hy sinh cao cả	
great army	đại quân	
great blessing	hồng phúc	
great change	đại biến	
great courage	gan chí mề	
great feat of arms	đại chiến công	
great majority	đại đa số	
great unity	đại đoàn kết	
greater every day	ngày càng nhiều	
greediness	túi tham	
greedy beyond measure	tham lam vô độ	
green bean cake	bánh đậu	
green jade	bích ngọc	
green manure	phân xanh	
greens and rice soup	rau cháo	
greeting card	thiếp mừng	
grieved	thảm sầu	
grilled meat	chả nướng	
grind at	giùi mài	
grit	sạn	
groom	mã phu	
groundnut or peanut oil	dầu lạc	
group (derogatory)	cái tụi	
grove of trees	lùm cây	
grow stupid	đờ mặt	
grunting of a pig	in ỉn	
guerilla	dư kích	
guest room	cái phòng khách	
guffaw	cười khà	
guidebook	cuốn trợ giáo	
guinea-fowl	gà sao	
gull	hải âu	
gun barrel	nòng súng	
gutter	ống xối	
haberdashery	hàng xén	
hacker (computer)	tin tặc	
Hades	Ngọc tuyền	
hail	mưa đá	
hairworm	giun tóc	
hale and hearty	quắc thước	
half an hour later	nửa tiếng đồng hồ sau	
half naked	cởi trần	
half wave antenna	ăng ten nữa sóng	
half-dead within an inch of one’s life	nhừ tử	
half-smile	cười nửa miệng	
half-way	nửa đường	
hallow	hốc	
hamlet	thôn xóm	
hammer handle	cán búa	
hampered	lướng vướng	
hand on one’s chin	chống cằm	
handed down from ancestors	gia truyền	
handgun	súng ngắn	
handicapped	tật nguyền	
handicrafts guild	phường hội	
handsome lad	xinh trai	
hang	xõa	
hang down	lỏa tỏa	
happen to die	mệnh một	
happenings	những việc xảy ra	
happy life	đời sống sung sướng	
happy news	hỉ tín	
hard	khó khăn	
hard and soft	cương nhu	
hard to do	khó nhá	
hard to forget	khó mà quên	
hard to recite	khổ độc	
hard-earned fortune	của mồ hôi nước mắt	
hardware	phần cứng	
harm oneself	thiệt thân	
harmony	hiệp hòa	
has been used for almost 78 years	đã được sử dụng gần 78 năm	
hatless	đầu trần	
have a drunken drawl (in one’s voice)	kè nhè	
have a fever	phát sốt	
have a heart-to-heart talk	nỉ non	
have a running nose	sổ mũi	
have a slight headache	nặng đầu	
have consideration for	vị mặt	
have gumption	khéo xoay	
have loose customs	điếm đàng	
have nothing to eat	vêu mõm	
have one’s heard throbbing	đánh trống ngực	
have one’s trousers off	ở truồng	
have the heart to do something	nỡ nào	
haversack	túi dết	
having an immature smell (taste)	ngái	
having enough and to spare	dư dả	
having only a son	độc đinh	
hawker	hàng rong	
hazard	may rủi	
he himself	chính ông ta	
He was arrested	Nó bị bắt rồi	
head instructor	giảng nghiệm trưởng	
head night-watchman	hương kiểm	
head of state	quốc trưởng	
headless	như rắn mất đầu	
health service	y tế	
heartily	chí tâm	
heart-rending	chua xót	
heaven	thiên quốc	
heaven and earth	càn khôn	
heaven-worshipping ceremony	nam giao	
heavy	dày đặc	
heavy machine gun	đại liên	
heavy object	vật nặng	
hectare	héc ta	
heedless	bất ý	
he-goat with big goatee	dê xồm	
heliometer	nhật kế	
helix	ốc vặn	
help	khuông phù	
hematosis	biến huyết sác	
hemisphere	nửa trái địa cầu	
hen	gà mái	
herdsman	mục tử	
here	ở nơi này	
hereditary rank in the public service	ấm thụ	
hermaphroditic	ái nam ái nữ	
hero of labor	anh hùng lao động	
herring	cá mòi	
heterogeneous	bất thuần trạng	
heterotrophic	dị dưỡng	
hexahedron	lục diện	
hide (oneself) (from)	lẩn lút	
hiding place	chỗ núp	
high and slender	lênh khênh	
high building	cao ốc	
high mountain	cao sơn	
high ranking	cao cấp	
high tech	kỹ thuật tối tân	
high treason	đại nghịch	
high-bred	quý phái	
higher education	kiến thức cao	
high-ranking bonze	sư cụ	
hijacker	kẻ cướp máy bay	
hinge	bản lề	
hip bone	xương hông	
histology	mô học	
historical period	giai đoạn lịch sử	
historical summary	sử lược	
hitch	khúc mắc	
Ho Chi Minh City (Saigon)	Thành Phố Hồ Chí Minh	
hold a prayer for rain	đảo vũ	
hold great rejoicings	khánh hạ	
holidays	kỳ nghỉ	
holy	thiêng	
home phone number	nhà của	
homeless person	người vô gia cư	
homepage (WWW)	rang đầu	
honest	dân lành	
honesty	sự lương thiện	
honeysuckle	kim ngân hoa	
hood	chùm đầu	
hood (of a car)	đầu máy xe	
hoof lift net	vó	
hope	mầm non	
horizon	chân trời	
horn	tù và	
horoscope	số tử vi	
horse fly	ruồi lằng	
horsetail	mộc tặc	
hostile force(s)	thế lực thù nghịch	
hot red pepper (with small seed pointing upward)	ớt chỉ thiên	
hot springs	ôn tuyền	
hot weather	trời nực	
house of songstresses	ca lâu	
house servant	gia bộc	
housewife	nội trợ	
houttuynia	diếp cá	
How come you’ll be gone so long?	Sao ông đi lâu vậy?	
how could one know?	làm sao biết được	
How have you been lately?	dạo này thế nào	
how lucky	vạn hạnh	
howdah	bành voi	
huge	bao la	
human affairs	nhân sự	
human community	nhân quần	
human dignity	nhân phẩm	
human life	kiếp người	
human power(ed)	sức người	
human rights organization	cơ quan nhân quyền	
humanity	nhân đạo	
humiliate (someone) with remarks on his defects	nhiếc móc	
hundred	trăm	
hungry and thirsty	đói khát	
husband (one’s own)	ông xã	
husband and wife	phu phụ	
husband’s blood relations	họ nội	
hydrant	máy nước	
hydrodynamics	thủy động học	
hydrolysis	thủy phân	
hygrophyte	ẩm thực vật	
hypertext transfer protocol (http)	quy ước chuyển siêu tập tin	
I	moa	
I can take care of it	tôi lo được	
I had a flat tire	tôi bị bẹp lốp	
I thought it was someone else	tưởng ai	
I wish you good health	chúc ngài được bình an	
I’ll eat whatever there is	có gì em ăn nấy	
iceberg	băng sơn	
ice-cream	cà rem	
ichor (discharged from a wound)	nước vàng	
iconometer	ảnh kế	
idealism	duy tâm luận	
ideology	ý thức hệ	
idling	xớ rớ	
if necessary	nếu cần	
if that’s the case	nếu thế thì	
ill hearted	xấu bụng	
illegal	bất hợp pháp	
ill-fated	vô phúc	
illusory glory	hư vinh	
illustration (in a book	minh họa	
imagination	sự tưởng tượng	
immense	hải hà	
immigrant	người di dân	
Immigration and Naturalization Service (INS)	sơ di trú và nhập tịch	
immortal nature	tiên cốt	
impedance	trở kháng	
imperial (royal) capital	đế đô	
imperial carriage	long giá	
imperial inspection	tuần thú	
imperial mantle	long bào	
imperial palace	cung đình	
imperial title	tôn hiệu	
impetuous	phăm phăm	
implicit	hiểu ngầm	
important (thing	việc quan trọng	
important matter	chuyện quan trọng	
importation	nhập khẩu	
impractical	gáo dài hơn chuôi	
impression	cảm tưởng	
improvement	sự cải thiện	
in	bên trong	
in 1987	hồi 1987	
in a country	ở đất	
in a minute	trong một phút	
in a stage	trong giai đoạn	
in a twinkle	trong nháy mắt	
in a very short period of time	trong thời gian thật ngắn	
in accordance with	đúng với	
in addition	lại nữa	
in all areas	trên đủ mọi lãnh vực	
in an affected voice (different from one’s usual voice)	éo ợt	
in black and white	giấy trắng mực đen	
in closing	để kết thúc	
in compensation for losses	bù lỗ	
in critical condition	trong tình trạng cấp cứu	
in driblets	tí một	
in everyday	trong đời sống hàng ngày	
in front of	diện tiền	
in general	nói chung lại	
in history	trong lịch sử	
in many areas	ở nhiều mặt	
In most recent days	mới rồi	
in office	tại chức	
in one sense	trong một ý ngiã	
in one’s own opinion	trong suy nghĩ riêng	
in one's lap	trên đùi mình	
in order	tuần tự	
in order to avoid doing something	kẻo mà	
in part	phần nào	
in person	đích thân	
in practice	trên thực tế	
in principle	trên nguyên tắc	
in sb’s eyes	trong cặp mắt	
in somebody’s house	nhập gia	
in the ~ fashion	theo lối	
in the ~ -th century	trong thế kỷ thứ	
in the afternoon	vào buổi chiều	
in the bloom of youth	hơ hớ	
in the case of	về trường hợp	
in the Chinese style	theo kiểu mẫu Trung Hoa	
in the daytime	ban ngày	
in the end	rút cục	
in the flesh	vào thịt	
in the form of an arc	theo hình vòng cung	
in the last few years	trong mấy năm qua	
in the mid-1980s	vào giữa những năm 1980	
in the mirror	trong gương	
in the morning	vào lúc buổi sáng	
in the opinion	theo ý kiến	
in the right direction	đúng hướng	
in the same way	kiểu giống như	
in the world	ở trong hoàn hải	
in the year	tới năm	
in these primitive conditions	trong những điều kiện thô sơ	
in this way	như thế này	
in Vietnam	tại Việt Nam	
in what place (in a competition	vào hạng thứ mấy	
in(side) me	trong tôi	
incense	nhang	
incestuous	dâm loạn	
incite	nói bẩy	
incomparable	vô song	
incompetent	vô tài	
inconvenience	phiền lụy	
increase day by day	một ngày một tăng thêm	
incubate	nung bệnh	
index finger	ngón tay trỏ	
Indian Ocean	Ấn Độ Dương	
indicator	biểu số	
indispensable	không thể thiếu được	
individual training	huấn luyện cá nhân	
indomitable spirit	chính khí	
industrialization	kỹ nghệ hóa	
industry	công nghiệp	
inert gas	khí trơ	
infatuated	mê đắm	
inferior	lép vế	
inferior strategist	quân sư quạt mo	
infirmity	phế tật	
inflation	lạm phát	
influence peddling	mại quyền	
inform	thông sức	
inherit a privilege	thừa tập	
initial	đợt đầu	
initiative	sáng kiến	
injection needle	kim tiêm	
ink-jet	phun mực	
innards	nội tạng	
inner chamber	thâm cung	
inorganic substance	chất vô cơ	
ins and outs	nguồn cơn	
insecurity	sự bất an	
inseparable lovers	uyên ương	
inside of me	trong lòng tôi	
insincere	thiếu thành thật	
insolent to one’s superiors	mạn thượng	
inspiration	hứng tình	
instead	kia	
instigate to violence	phiến động	
instruct carefully	nhủ	
instrument	phối khí	
insulin	in xu lin	
insurance benefits	quyền lợi bảo hiểm	
insurgent troops	nghĩa quân	
intellect	tâm lực	
intelligence service	đặc vụ	
intense search	truy nã gắt gao	
interactive	liên ứng	
interest	tài lợi	
interest rate	lãi suất	
interface	giao diện	
interlocking devices	các phương tiện khóa liên động	
intermittent	cách quãng	
internal angle	góc trong	
internal disease	nội thương	
internal energy	nội năng	
internal medicine	nội khoa	
international conference	hội nghị quốc tế	
international exchange	giao dịch quốc tế	
international trade	thương mại quốc tế	
interpretation	thông dịch	
interrupter	ngắt điện	
intervalometer	thời kế	
intricate	mắc mứu	
introduction (to a book)	lời vào đề	
introductory words	lời giới thiêu	
intuition	trực dịch	
invader	giặc trời	
invention	sự sáng tạo	
invest money with someone else	chung chân	
investigative committee	ban điều tra	
investor	người đầu tư	
involved	nhiều cửa	
iron and blood	sắt máu	
iron bowl	bát sắt	
iron staff	thiết côn	
ironwood	gỗ tứ thiết	
irritate	nhặm	
is enough to show	là đủ để biết	
is not	không phải là	
is that so?	thế à	
island	hải đảo	
isolationism	chinh sách cô lập	
isotope	chất đồng vị	
it doesn’t make sense if	không lẽ	
it had been a long time	đã từ lâu	
it is clear that	rõ là	
it is necessary (to)	tất phải	
it should be noted	nên để ý là	
it’s best not to beat around the bush	nói gần nói xa không qua nói thật	
it’s Mr. Nam’s turn	đến Ông Nam	
italics	chữ ngả	
item	món hàng	
ivory symbol of office (of a Mandarin)	bài ngà	
jabiru	cò đen	
jackal	sài cẩu	
jade	ngựa nghẽo	
jade-like	ngọc ngà	
jammed with people	đông như trẩy hội	
Japan	Nhật	
Japanese (person)	người Nhật Bản	
jaundice	hoàng đản	
jealous	ghen	
jejunum	hỗng tràng	
Jesus	Giê Su	
jiu-jitsu	nhu thuật	
job application	xin việc làm	
joint	hỗn hợp	
joint ownership	đồng sở hữu	
joss-sticks and flowers	hương hoa	
judgment	sự nhận định	
juicy longan	nhãn nước	
jumping goby	cá thoi loi	
Jupiter	Mộc	
just now	ban nẫy	
jute	đay	
kamikaze	thần phong	
kapok	bông gạo	
karma derived from bad actions	oan trái	
keen-eared	sáng tai	
keep a post-natal diet	khem	
keep pace with	ngang tầm	
keep the bank	làm cái	
kestrel	chim cắt	
key	china thìa	
khaki	ka ki	
kick a shuttle cock	đá cầu	
kickboxing	quyền cước	
kill	hạ thủ	
kilovolt	ki lô vôn	
kind and generous	độ lượng	
kind of chess game	chân chó	
kind-hearted	phúc hậu	
kindness	lòng tốt	
kinetic energy	động năng	
king’s last will	di chiếu	
king-father	phụ hoàng	
kinky hair	bụt ốc	
kinship	thân tộc	
knavish	xỏ lá	
kneecap	đầi gối	
knitting-machine	máy dệt kim	
knot (unit of speed)	hải l‎ý giờ	
knowledge engineering	công nghệ tri thức	
Korea	Đại Hàn	
kowtow	hưng bái	
Kremlin	điện cẩm linh	
Kyushu (region of Japan)	Cửu Châu	
labiodental	thần sỉ âm	
labio-dental sound	âm môi răng	
labor disputes	vụ tranh chấp lao động	
labor party	công đảng	
laboriously	như vạc ăn đêm	
lady paramount	nữ chúa	
laissez-faire	sống chết mặc bay	
lame leg	chân què	
lament incessantly	rền rỉ	
lamp smoke	khói đèn	
land development centre	khu dinh điền	
landing spot	địa điểm hạ cánh	
landmine	địa lôi	
language-description language	siêu ngôn ngữ	
lantern	đèn cù	
large glazed earthenware jar	khạp	
large round egg plat	cà bát	
large socks	đá lớn	
laryngology	thanh quản học	
laser beam	tia kích quang	
lasso	thòng lọng	
last night	tối hôm qua	
last ten days of a month	hạ tuần	
late at night	khuya	
lately	thời gian qua	
lateral	biên âm	
latex	nhũ dịch	
lathing	lát ti	
laugh almost hysterically	cười sằng sặc	
laundromat	nhà máy giặt	
laureate	khoa giáp	
law	luật	
law of the labor union	luật lao động	
law school	trường luật	
laws	pháp chế	
lax	sự kiểm soát lỏng lẻo	
lay the table	dọn ăn	
layer of stone	lớp đá	
lead ball	đạn chỉ	
leader	lãnh tụ	
leading issue	vấn đề hàng đầu	
leading role	vai trò chỉ dạo	
leaf (of a plant)	lá cây	
lean and fat meat mixed	thịt ba chỉ	
leave (money or property) to somebody	để của	
lecturer	báo cáo viên	
left and right	tả hữu	
left wing	cánh tả	
legally	một cách hợp pháp	
legendary	hư truyền	
legislative	lập pháp	
leisurely	nhẩn nha	
lender	chủ nợ	
lentil and foam	bèo bọt	
leprosy	phung	
let out secrets while speaking	sổng miệng	
letter to the editor	thư bạn đọc	
level	bình diện	
lever	đòn bẩy	
liana	dây leo	
library	thư viện chương trình	
lie curled up	nằm co	
lie stretched out	nằm thượt	
life cycle	vòng sống	
lifetime	sinh thời	
light music	nhạc nhẹ	
light soil	đất nhẹ	
light-footed	nhon nhỏn	
like a big dull-head	ngộc nghệch	
like a moment ago	như lúc nãy	
like brother(s) and sister(s)	như anh em	
like me	như mình	
lime	vôi	
limited	hạn hẹp	
limitless power	nỗ lực vô hạn	
line of intersection	giao tuyến	
line of sight	đường ngắm	
line segment	đoạn thẳng	
lingo	giọng lưỡi	
link forefingers (in sign of a contract agreed upon)	ngoặc tay	
lion	sư tử	
liquid fuel	nhiên liệu lỏng	
lisp	ngọng nghịu	
listen to me carefully	nghe tôi cho kỹ	
listening device	máy nghe	
literary contribution	đóng góp văn học	
literary language	ngôn ngữ văn học	
literary value	giá trị văn học	
literati	sĩ lâm	
little by little	lần hồi	
little girl	con bé con	
live in groups	quần cư	
livelihood	sinh nhai	
load shedding	sa thải phụ tải	
loaf	lêu lổng	
local currency	đồng bạc địa phương	
local official	cán bộ địa phương	
local press	báo chí địa phương	
local station (as opposed to express)	ga xép	
location	điểm đặt	
lock (in a canal)	cống ngăn	
locution	quán ngữ	
logistics	tiếp vận	
lonely	trơ trọi	
long ago	năm xưa	
long and exacting	dài hơi	
long life	tuổi thọ	
long live	muôn năm	
long road	đường trường	
long-horned grasshopper	sạt sành	
long-lived	trường thọ	
long-standing	lâu đời	
long-winded	dài dòng	
look up	nghếch mắt	
loophole	lỗ châu mai	
Lord Jesus Christ	đức Yêsu Kitô	
lose one’s appetite	ngang dạ	
lose one’s self-control	đâm khùng	
losing freshness	phếch	
lots of things to do	nhiều chuyện để làm	
loud	rầm	
loudly	lớn tiếng	
love	ái ân	
love (or friendship) late in life	vãn duyên	
loveable	khả ái	
love-letter	tình thư	
lovemaking	việc làm tình	
lovesick	tương tư	
low pressure	hạ áp	
lower house	viện dân biểu	
lower part of the abdomen	hạ bộ	
low-ranking mandarin	hành tẩu	
loyal	chân thành	
luce	cá chó	
luckily	cũng may	
lucky hour	giờ hoàng đạo	
lumber (under the weight of a heavy load)	khệ nệ	
luminous precious stone	dạ minh châu	
lung-disease	bệnh đau phổi	
lustful	dê cụ	
lycopod	thạch tùng	
lymphoma	ung thư hạch	
machinate	trù mưu	
macrocyte	đại hồng cầu	
made by X himself	do chính X tự lập	
maggot	giòi	
magic square	ma phương	
magnanimous	đại độ	
magnetic head (of a tape recorder)	đầu từ	
magnetic tape	dây nhựa	
Mahayana Buddhism	Phật Giáo đại thừa	
mail program	chương trình thư	
main	vấn đề chính	
main axis	chính trục	
main force	chủ lực	
main program	chương trình chính	
main rope (of a fishing-net)	giềng	
mainly because of	chính là do	
maize	ngô	
major general	thiếu tướng	
make (cause) trouble for the coming generations	di lụy	
make a loose translation	lược dịch	
make a rough translation	phỏng dịch	
make it another time	để khi khác	
make preparations for the tenth-month rice crop	làm mùa	
make up a story	nặn chuyện	
male	con đực	
male bird and female bird	sống mái	
males-only	độc nam	
mammal	có vú	
man of eminence	tuấn sĩ	
management	chủ nhân	
mandarin orange	quít	
mandarin’s grandson	ấm tôn	
mandate	ủy trị quyền	
mandrel	cuốc chim	
maneuvering flight	bay thao dượt	
mangrove	đước	
manioc	khoai mì	
mankind	thế nhân	
manner	cung cách	
manslaughter	ngộ sát	
manufacturer	nhà chế tạo	
many diseases	bá bệnh	
many styles of handwriting	nhiều lối viết tay	
many years ago	cách đó nhiều năm	
map	bản đồ	
march	quân ca	
Mare Imbrium (lunar sea)	Biển Mưa Gió	
margin	bìa sách	
marine	lính thủy đánh bộ	
market day	phiên chợ	
market share	thị phần	
marketing method	phương pháp tiếp thị	
marriage bonds	tơ duyên	
marriage ties	dây tơ hồng	
marrow	cốt tủy	
Mars (planet)	sao Hỏa	
martial	thượng võ	
martne corps	hải quân lục chiến	
marvelous efficacy	thần hiệu	
massage by pulling the back	bẻ bão	
master of horse	tư mã	
mat shed (for the students to take along at the	lều chiếu	
material	chế liệu	
material(s)	vật liệu	
maximum	tối đa	
mayor	thị trưởng	
maze-like	nhằng nhịt	
meal	buổi cơm	
mean	nhỏ nhen	
means of earning the family’s rice	gia kế	
means that	muốn nói là	
measles	sởi	
measure weighing about thirty kilograms of grain	giạ	
measures	các biện pháp	
mechanically	như chiếc máy	
medal	huân chương	
mediate a peace (between two parties)	giải hòa	
medical equipment	y cụ	
medical examination	xem bệnh	
medicine (as a field of study)	y học	
medieval	trung cổ	
Mediterranean Sea	địa trung hải	
medium dose	liều lượng vừa phải	
medium scale map	bản đồ tỷ lệ trung bình	
meet face to face	hội diện	
meet with misfortune	ngộ biến	
meeting a woman as one goes out of the house	gặp gái	
Mekong river	sông Cửu Long	
melanin (pigment found in skin	hắc tố	
melt	nóng chảy	
member of a party cell executive	chi ủy viên	
member of the same family	tôn tộc	
men of character	thanh lưu	
meningitis	màng não	
menstruation	chu kỳ kinh nguyệt	
mentioned above	nêu ra ở trên	
menu bar	thanh đơn chọn	
merit	công tích	
mesology	môi trường học	
messy	bê bết	
metallography	kim loại học	
metamorphized rock	đá biến tính	
meteorology	khí tượng học	
mezzanine	gác lửng	
microchip	linh kiện li ti	
microphone	mi crô	
microwave	vi ba	
midday	giờ ngọ	
middle front vowel	mẫ âm trước trung	
middle-aged matron	nạ dòng	
mid-high vowel	mẫu âm giữa cao	
midwife	bà mụ	
mile	dặm	
military band	đội quân nhạc	
military chief (under the reign of kings hung)	lạc tướng	
military discipline	quân kỷ	
military force(s)	lực lượng quân sự	
military man	binh gia	
military objective	mục tiêu quân sự	
military post	đồn bốt	
military training	huấn quân sự	
militia	dân quân tự vệ	
milk product(s)	sản phẩm sữa	
millennium	thiên niên kỷ	
mind	trí	
minefield	bãi mìn	
mineral	khoáng	
minerals	khoáng sản	
Ministry of Domestic Affairs	Bộ Nội Vụ	
Ministry of Industry	Bộ Công nghiệp	
Ministry of Trade	Bộ Mậu Dịch	
minor official of a ministry	tá lý	
minority (person)	dân thiểu số	
Minshato (Japanese political party)	đảng Dân Xã	
miraculous	linh nghiệm	
miscellany	tạp lục	
miscrospore	tiểu bào tử	
misfortune	bĩ vận	
miss (a meal	hụt ăn	
mission	phái bộ	
misunderstanding	ngộ hội	
mix	hỗn nhập	
mizzen-sail	buồm lái	
mobile station	trạm di động	
mode	mẫu mã	
model (person)	người mẫu	
moderate behavior	thái độ hòa hoãn	
modern (western) education (as opposed to traditional education)	tân học	
modern idea	tư tưởng cận đại	
modern times	đại ngày nay	
modern warfare	chiến tranh cận đại	
modernization program	chương trình hiện đại hóa	
module	mô đun	
molasses	mật mía	
molten	nóng lỏng	
monarchist	tôn quân	
money	tiền tệ	
money matters	lý tài	
monk (who goes from place to place to raise money)	hành giả	
monkey business	ma ăn cỗ	
monogamy	chế độ một vợ một chồng	
monography	địa chí	
monovalent	đơn trị	
moonlight	bóng nguyệt	
moorcock	bìm bịp	
morality	thuần phong	
more and more	càng thêm	
more dead than alive	thập tử nhất sinh	
more than a half	già nửa	
more than all	hơn hết	
more than twice as much	gấp quá hai lần	
morphia	moóc phin	
morphology	từ pháp	
mortal remains	di hình	
mortar (weapon)	súng cối	
mortise	lỗ mộng	
most likely	rất có thể	
most recent(ly)	gần đây nhất	
mostly or always	hoàn toàn hoặc phần lớn	
moth balls	băng phiến	
mother	bà bô	
mother by adoption	nghĩa mẫu	
motive force	đầu tàu	
motorbike	xe gắn máy	
motorcade	đoàn xe	
mountain of garbage	núi rác	
mounted soldier	kỵ mã	
mourning clothes	hiếu phục	
mouth	cái miệng	
mouth of a well	miệng giếng	
mouthful	ngụm	
move in	tiến đến	
moving	lâm li	
MP3 format	dạng MP3	
Mr. Bau	anh Báu	
much	nhiều	
muckheap	đụn rác	
mudguard	chắn bùn	
mulberry-tree and fleabane	tang bồng	
multicultural	đa văn hóa	
multiform	thiên biến vạn hóa	
multipath	đa tia	
multiplication	nhân giống	
multiprogram	đa chương trình	
multisystem	đa hệ	
munching noise	nhóp nhép	
murder rate	mức độ sát nhân	
muscular	vạm vỡ	
museum	bảo tàng viện	
music (and singing)	ca nhạc	
muslin	mút xơ lin	
mustard	cải cay	
mutual conductance	hỗ dẫn	
my children	các cháu	
my dearest	ái nương	
my head aches	tôi nhức đầu	
my room	phòng tôi	
my shoulder is itching	vai tôi ngứa	
mythology	truyện thần	
name and title	lạc khoản	
name of a vegetable	rau sắng	
named after	được đặt theo	
narrative genre in first person	tự sự	
narrow meaning	nghĩa hẹp	
national anthem	quốc ca	
national customs and manners	quốc phong	
national historiographer’s office	quốc sử quán	
national policy	quốc sách	
national treasure	bảo vật quốc gia	
nationalist	dân tộc chủ nghĩa	
native country	cố quốc	
native of	vốn người	
native soldier	khố đỏ	
natural phenomenon	thiên tượng	
natural sciences	bác vật học	
naturalization application	đơn xin nhập tịch	
nature	thiên nhiên	
naval support area	hải khu hải trợ	
navel	lỗ rốn	
navy	căn cứ hải quân	
nearby	ở khoảng cách gần	
nearly two weeks	gần hai tuần lễ	
nebula (astronomy)	tinh vân	
neck (flesh of an animal’s neck)	nọng	
negative electricity	âm điện	
negative phase sequence current	dòng điện thứ tự nghịch	
neglected	hoang sơ	
negotiation	cuộc thương nghị	
neighbor	người hàng xóm	
neighboring country	lân bang	
nerve	gân	
nervure	gân xanh	
network operator	nhà điều hành mạng	
neutral grounding	nối đất trung tính	
new democracy	tân dân chủ	
new life	tân sinh	
new trend	tân trào	
newborn (infant)	hài nhi	
newest	mới nhất	
newly formed	sơ sinh	
news flash	quang báo	
news report	phóng sự	
news-less	bặt tin	
newspaper office	tòa báo	
new-type colony	thuộc địa kiểu mới	
next month	tháng sau	
nib	ngòi viết	
night flying chart	bản đồ dạ phi hành	
nightclub	cái hộp đêm	
night-soil	phân bắc	
ninth	đệ cửu	
nitpicky	bới lông tìm vết	
no different from (something)	không khác gì	
no effect without cause	không có nhân sao có quả	
no one	không ai	
no pain	tay làm hàm nhai	
no sooner said than done	nghĩ là làm	
no worries	khỏi thắc mắc	
Nobel prize	giải Nobel	
nocturnal rain	dạ vũ	
noise antenna	ăng ten trừ nhiễu âm	
noisily	rần rần rộ rộ	
Nom poetry	thơ Nôm	
nominal	danh định	
nomination	việc đề cử	
non-aggression treaty	hiệp ước bất xâm phạm	
non-professional	không chuyên	
non-resident	ngoại trú	
noon	giữa trưa	
normal conditions	tình trạn bình thường	
normalization	bình thường hóa	
North Atlantic Treaty Organization	Khối Phòng Vệ Bắc Đại Tây Dương	
North(ern) Vietnam	Bắc Việt	
northern wind	bắc phong	
not applicable	không áp dụng	
not at all	cóc khô	
not bold enough	non gan	
not far away	đâu có xa	
not lacking in importance	không kém quan trọng	
not normally allowed	bình thường không được phép	
not only	không những chỉ	
not to be involved (in something)	vô can	
not to have fortune on one’s side	bạc đức	
not to like	bất phục	
not to receive any news (from)	vắng tiếng	
not until later	mãi đến sau này	
not very long	chẳng được bao lâu	
not worth the money	không bõ	
notable	thân hào	
note (music)	âm hiệu	
noteworthy	đáng nói	
nothing done	hỏng kiểu	
notochord-chordata	dây sống	
novel	tiểu thuyết	
now flexible	lúc nhu lúc cương	
now then!	ối dào	
n-th time	lần thứ	
nuclear bomb	bom nguyên tử	
nuclear reactor	lò nguyên tử	
nuclear weapon	vũ khí hạt nhân	
number	con số	
nuptial chamber	phòng loan	
nurse maid	vú em	
nursery	vườn ươm	
nutmeg	nhục đậu khấu	
nylon	ni lông	
obelisk	bút tháp	
obey the order	vâng dạ	
object oriented	khuynh vật	
object-oriented programming	lập trình hướng đối tượng	
observations	những lời nhận xét	
observer	nhà quan sát	
occasionally	thi thoảng	
ocean	hải dương	
octagonal building	tòa nhà bát giác	
odor	hơi hám	
of a man of the world	đủ điều	
of course	lễ cố nhiên	
of great worth	có giá	
of their own	của riêng họ	
off the coast of	ngoài khơi	
offend the ear	rác tai	
offer incense	thượng hương	
offer suggestions	hiến kế	
office	buồng giấy	
office-boy	tùy phái	
officer in charge of farms	doanh điền sứ	
official name of a country	quốc hiệu	
official policy	đường lối chính thức	
officialdom	bách quan	
offset	lệch trục	
often	thường khi	
oho! aha!	cha chả	
oil rig	giàn khoan dầu	
oil-cake	khô dầu	
oil-paper	giấy dầu	
old (female) servant	u già	
old age	tuổi già	
old book	sách vở cũ	
old lady	bà cụ	
old official in court	lão thần	
old sow	lợn sề	
old woman	bà già	
old-fashioned	cũ rích	
olive-colored	màu chàm	
on a large scale	hoành tráng	
on a national level	trên bình diện tòn quốc	
on duty	thường trực	
on mortgage	sai áp	
on one’s heels	chò hỏ	
on one’s lips	trên môi	
on the back of one’s neck	đằng sau gáy	
on the contrary	chứ lị	
on the front page	trên trang nhất	
on the hoof	móc hàm	
on the one hand	một mặt	
on the part of Vietnam	phía Việt Nam	
on the right side	ở mé phải	
on the side of	về phía	
on the surface of the snow	trên mặt tuyết	
on this day	vào ngày hôm nay	
once every six months	mỗi sáu tháng một lần	
one among	một trong số các	
one half	một nửa số	
one hundred years	trăm năm	
one month	một tháng	
one reason	một lý do	
one type of egg plant	cà ghém	
one week	một tuần	
one year old	tuổi tôi	
one’s hair	mái đầu	
one’s liking	như ý	
one’s own efforts	những cố gắng bản thân	
one-two-three (game played by small children)	oằn tù tì	
only a year later	chỉ một năm sau	
only India refused	riêng Ấn Độ từ chối	
only when the hand is injured	đứt tay hay thuốc	
onomatopoeia for the grunting of pigs	ủn ỉn	
onomatopoeia of sound of cymbals	xập xòe	
oosphere	noãn cầu	
open	mở ngỏ kinh tế	
open (the door) wide	mở toang	
open land	đất trống	
open-handed	hào phóng	
operand	toán hạng	
operating table	bàn mổ	
operational startup document	văn bản nghiệm thu	
operator	hiệu thính viên	
opium addicts	dân bẹp tai	
oppose	chống	
opposite hand	chống tay	
opposition party	phe đối lập	
optical cable	cáp quang	
or something like that	hay gì đó	
orchiocele	sa đì	
order of precedence	ngôi thứ	
ordinary people	chúng thường	
ore	quặng mỏ	
organic chemistry	hóa học hữu cơ	
organism	cơ thể	
orgasm	khoái cảm nhất	
original (copy)	bản chính	
orixa japonica	thường sơn	
orthocentric	trực tâm	
orthodox religion	chính giáo	
other place	nơi khác	
oust	chèn bẩy	
out of malice	vì ác ý	
out of rhyme	thất vận	
out of sight	khuất mắt	
out the door	ra cửa	
outbreak	bùng phát	
outdated	cổ hủ	
outing (to have fun)	buổi đi chơi	
output contact	tiếp điểm đầu ra	
outside (appearance)	mặt ngoài	
outside of town	ngoài thành phố	
outstanding	bạt chúng	
outstanding talent (genius)	đặc tài	
over (or during) the last two weeks	trong hai tuần vừa qua	
over one’s head	ngập đầu	
over time	theo thời gian	
over-fervid	cuồng hứng	
overheads	sở hụi	
overloading	quá tải	
overproduction	khủng hoảng thừa	
oversized	ngoại cỡ	
overwhelming majority	tuyệt đại đa số	
ovulation	rụng trứng	
owner of a business	ông chủ nhà hàng	
oxide	oxit	
oxyhaemoglobin	huyết cầu tố	
pace	nhịp đi	
pacify	trấn định	
package	gói hàng	
packet (in a network)	lá thư điện tử	
pact	minh ước	
paging	phân trang	
paint store	tiệm sơn	
paintwork	lớp sơn	
pair of clothes	bộ đồ	
pair of wings	đôi cánh	
palanquin	kiệu	
palatal	khẩu cái âm	
pale face	mặt tái mét	
Pali canons	Phạn điển	
pancreas	tụy tạng	
panicky	hoảng hốt	
pant	hổn hà hổn hển	
pantomime	kịch câm	
paper and bamboo puppet (to be burned on worship)	hình nhân	
paperback book	cuốn cẩm nang	
paraclinical	cận lâm sàng	
parallel to	song song với	
paralyzed	bại liệt	
paramilitary	bán quân sự	
parcel	bưu kiệm	
parents	cha mẹ	
pariah	tiện dân	
parliament	nghị viện	
parson’s nose	phao câu	
part of speech	từ loại	
participant	người tham dự	
particularize	đặc thù hóa	
party character	đảng tính	
party committee appointed to offices and other	đảng đoàn	
pass an examination	cập đệ	
passer-by	khách qua đường	
passive	bị động	
past pupil	cựu học sinh	
patch over again	đụp	
patella	xương bánh chè	
paternal grandmother	bà nội	
pathetic	bi thương	
patriarchy	chế độ gia trưởng	
patrol	tuần binh	
patron	mạnh thường quân	
pattern	trình thức	
pavement	bờ hè	
paw	cẳng	
pay for piecework	lương khoán	
peace and prosperity	khang cát	
peace treaty	hòa ước	
peaceful and prosperous	thái bình	
peacekeeping troops	lực lượng hòa bình	
peak voltage	xung điện áp	
pearls and gem	châu ngọc	
pedestrian	bộ hành	
pediatrics	nhi khoa	
Peiping	Bắc Bình	
pell mell	sô bồ	
pelt	da sống	
penalty	phạt	
pencil	bút chì	
peninsula	bán đảo	
Pentagon official	viên chức Ngũ Giác đài	
people	dân gian	
people do whatever they want	ai muốn làm gì thì làm	
people’s teacher	nhà giáo nhân dân	
peppery chamber (of the queen)	tiêu phòng	
perennial	cây lâu năm	
perfect enlightenment	viên giác	
perfectly round	tròn vo	
perform	trình tấu	
perfunctory	vấy vá	
peripheral	thiết bị ngoại vi	
peristaltic	nhu động	
perm	uốn tóc	
permanent magnet	nam châm vĩnh cửu	
permit	giấy phép	
personal	bản thân	
personal dignity	phẩm cách	
personal independence	độc lập cá nhân	
personally (I feel	cá nhân tôi	
perspective	phối cảnh	
petition to the king	sớ	
petty official	chủ sự	
phagedaena	sâu quảng	
pharmacist	dược sĩ	
pharmacy	dược khoa	
phase-to-ground	pha-đất	
phenomenology	hiện tượng luận	
philosopher	hiền triết	
phó phòng	PP	
phonetic symbol	âm phù	
phonology	âm thanh học	
photographer	nhà nhiếp ảnh	
photomagnetic	quang từ	
photostatic copy	bản phóng ảnh	
physical	vật lý	
physical property	tính chất vật lý	
physically exhausted	mệt lả	
physicochemical	hóa lý	
physignathus	rồng đất	
physiotheological	vật lý thần học	
pick up	chắt mót	
pickled bean sprouts	dưa giá	
picture processing	xử lí ảnh	
piece of mail	bưu phẩm	
pieces	manh mún	
piercing pain in the bones	nhức xương	
piggish	ngồm ngoàm	
pile of money	đống tiền	
pillar	cột trụ	
pillow-block	ổ trục	
pimp	chim xanh	
pine resin	nhựa thông	
pin-prick	nói chọc	
pioneer	người tiên phong	
pipette	pi pét	
pitiful	thảm trắc	
place name	tên địa dư	
place somebody’s remains in a small terra-cotta coffin	sang tiểu	
placid lake	mặt hồ phẳng lặng	
plain silk	lục soạn	
plain white	trắng trơn	
plane (in geometry)	mặt phẳng	
plane geometry	hình học phẳng	
planning chart	bản đồ thiết kế chiến thuật	
plantain	chuối lá	
plants	thảo mộc	
plasterer’s hawk	bàn xoa	
platform	kỳ đài	
platter (made of coarse porcelain)	bát đàn	
play a single (at tennis)	đánh đơn	
play pranks	chơi nghịch	
player	nhà nghề	
pleasant smell	mùi thơm	
please introduce oneself	xin giới thiệu	
please ring (the bell or buzzer)	xin bấm chuông	
pleased to meet	hân hạnh được gặp	
plentiful	bề bề	
plot	mưu mánh	
plough again or anew or over	cày đảo	
plumb-line	dây dọi	
plural	số nhiều	
pneumatics	khí lực học	
poem	bài thơ	
poems and songs	thi ca	
poetic	phong tao	
poets’ circle	thi xã	
point again	chỉ lại	
pointless	vô lối	
poison	thuốc độc	
pole slip	trượt cực từ	
police academy	học viện cảnh sát	
police report	tin cảnh sát	
police station	bót	
policeman	ông cảnh sát	
politeness	lễ phép	
political advisor	cố vấn chính trị	
political arena	chính trường	
political controversy	tranh chấp chíng trì	
political education	huấn chính	
political leadership	lãnh đạo chính trị	
political movement	phong trào chính trị	
political science	chính trị học	
political struggle	đấu tranh chính trị	
polyatomic	đa nguyên tử	
polynia	ao băng	
polyvitamin	đa sinh tố	
poncho	pon cho	
pontoon bridge	cầu phao	
poor	nghèo khổ	
poor area	khu nhà nghèo	
poor behavior	hạnh kiểm yếu	
population	cư dân	
populous area	khu trù mật	
pork cut at joint of tail-crupper	khấu đuôi	
pornographic pictures	hình ảnh khiêu dâm	
port of entry	cửa khẩu	
porter	cửu vạn	
positive pole	đầu dương	
possible terrorist	những kẻ có thể là khủng bố	
postal service	bưu vụ	
post-classic	hậu cổ điển	
postfix notation	kí pháp sau	
posture	dáng người	
pot	chậu	
potato	khoai tây	
pots and pans	xoong chảo	
pottery kiln	lò gốm	
powder and perfume	phấn hương	
powder-filled paper string	pháo dây	
powerful enemy	cường địch	
practical	thiết thực	
prawn	tôm he	
pre-betrothal ceremony	vấn danh	
precinct chief	hộ phố	
precious stone	hòn ngọc	
precise synchronization system	hệ thống hòa đồng bộ chính xác	
pre-death tomb	sinh phần	
preface	tiểu dẫn	
preliminary examination	sơ khảo	
preliminary selection	sơ tuyển	
premier	thủ tướng	
prescription	thời hiệu	
present a play	diễn kịch	
present condition	hiện trạng	
preservation of secrecy	bảo mật	
presidential candidate	ứng cử viên tổng thống	
presidential system of government	tổng thống chế	
press conference	buổi họp báo	
press organization	cơ quan báo chí	
press-stud	khuy bấm	
pretty good (exam score)	bình thứ	
preventing	việc nhăn cản	
preventive of exidemy	phòng dịch	
previous life (Buddhism)	tiền sinh	
pride	tự ái	
primary	vỡ lòng	
prime minister	tể tướng	
prince	vương tướng	
principal (of an offence)	chính phạm	
printer	nhà in	
printing (as a craft or profession)	nghề in	
prior to this	trước đó	
prisoner	người tù	
prisoner under death penalty or sentence	tử tù	
private	tư doanh	
private bank	ngân hàng tư nhân	
private conversation	nói chuyện riêng	
private property	tư sản	
privatization	tư hữu hóa	
process	nhiệm toán	
product	sản vật	
product safety	an toàn sản phẩm	
production relations	quan hệ sản xuất	
professionally	một cách chuyên nghiệp	
profit and loss	lời lỗ	
profitableness	doanh lợi	
prohibited area	vùng cấm	
project manager	công trình sư	
projection room	khán phòng	
prolific	tốt nái	
prompt (an actor)	nhắc vở	
proof	bản in thử	
propaganda with the population	dân vận	
properties (of a play)	đạo cô	
property damage	thiệt hại vật chất	
proposal	đề án	
prose	văn xuôi	
prosperous	cực thịnh	
protective forest	rừng phòng hộ	
protective patrol	tuần phòng an ninh	
protest movement	phong trào phản kháng	
protoplasm	nguyên sinh chất	
protractor	thước đo góc	
proverb	tực ngữ	
province chief	chủ tỉnh	
provincial guard	lính cơ	
pry into	nhòm nhỏ	
pseudopod	giả túc	
public and private	công tư	
public good	công lợi	
public law	công pháp	
public prosecutor	công tố viên	
public security	công an	
publication	việc công bố	
puff-snake	rắn phì	
pulley	bánh đai	
pulse	kinh mạch	
punches and kicks	cú đá	
punish	thảo phạt	
pupa	nhộng	
puppet army or troops	ngụy quân	
puppet show	kịch búp bê	
pure mathematics	toán học thuần túy	
purely scientific	chỉ thuần túy về khoa học	
purple heron	diệc lửa	
purposely	cố tình	
put on a bold front	nói cứng	
pyramidal rice dumpling	bánh giò	
quail	cun cút	
quantic	nguyên lượng	
quarterdeck	boong sĩ quan	
question	câo hỏi	
quicksand	cát vần	
quiet and deserted	thanh vắng	
quill	con suốt	
quilted robe	áo bông	
quintessence	tinh anh	
quite red	đỏ lựng	
rabid or mad dog	chó dại	
racing (bi)cycle	xe đạp đua	
radar board	bảng ra đa	
radiating energy	năng lượng bức xạ	
radio	ra đi ô	
radioactive isotopes	năng lượng phóng xạ	
railroad	đường sắt	
rainbow	cầu vồng	
rain-gauge	vũ kế	
rainy	trời mưa	
raise a subscription	quyên góp	
raise an army for a war	khởi binh	
raise one’s cup of wine	cất chén	
raise troops	dấy quân	
rajah	tiểu vương	
ramp	bệ phóng	
ranch	đồn điện	
rapidly	lịa	
rarely	mấy khi	
rather flexible	deo dẻo	
rather short	ngăn ngắn	
ration (of food	khẩu phần	
rational number	số hữu tỉ	
rattlesnake	mai gầm	
raw and working material	nguyên vật liệu	
razor	dao cạo	
reach	tầm	
reactive power	công suất phản kháng	
read only	chỉ đọc	
reader (textbook)	độc bản	
re-adjust (re-arrange) the tiles (of a roof)	đảo ngói	
real goods	hàng thật	
real strength	thực lực	
reality and myth	thực hư	
realize plainly	nhận chân	
really true	đúng thật	
rear	hậu phương	
rear-view mirror	gương hậu	
reasonability	việc phải chăng	
rebel	khởi loạn	
receipts and expenses	thu chi	
receive a promise	được lời	
recently	những ngày gần đây	
reception	tiếp tân	
recess (of court)	bãi triều	
reckless	sừng sỏ	
recluse	ẩn sĩ	
recommendation	lời khuyến cáo	
record low (level)	mức thấp kỷ lục	
recursion	đệ qui	
red cross	hồng thập tự	
red pawn	tốt đỏ	
red sugarcane	mía đỏ	
red turtle dove	cu ngói	
red-eyed carp	cá chày	
reduce	giản ước	
reduce speed	giảm tốc	
reducing	giảm nhiễm	
reed (used to weave sleeping mat)	cói	
reeducation camp	trại cải tạo	
refined	nho nhã	
reflexive	phản thân	
refresher instruction	huấn luyện bổ túc	
refringent	chiết quang	
refuse	chất phế thải	
regatta	đua thuyền	
regional examination	hương thí	
registration card	thẻ đăng tuyến	
reign	đế nghiệp	
reinforced concrete	bê tông cốt sắt	
related to	có dính dáng tới	
relation by marriage	thích thuộc	
relationship	giao thiệp	
relatively stable	tương đối ổn định	
relatives and strangers	thân sơ	
relatives on one’s mother’s side	ngoại tộc	
relay	chạy tiếp sức	
relics	thánh tích	
relieve one’s melancholy	giải buồn	
religious affairs director (Cao Dai)	Thượng Phẩm	
religious faith	đạo tâm	
religious group	giáo phái	
religious prisoner	tù nhân tôn giáo	
remaider (after division)	thặng	
remission	miễn giảm	
remnants of a (defeated) army	tàn quân	
remotely	từ xa	
renanthera	khô mộc	
repay (funds	trả vốn to	
reporter	ký giả	
reprove	dức	
Republican party	đảng Cộng hòa	
request	khất từ	
research	việc học hỏi	
research method	phương pháp nghiên cứu	
reservoir	bồn chứa	
residence	cư trú	
resist	chống báng	
resistance	điện trở	
resort village	thành phố nghỉ mát	
respect	sự kính trọng	
respectful notice	kính báo	
restaurant	cao lâu	
restrictions (to one’s freedom) (figurative) officialdom	cương to	
resultant force	tổng lực	
retail price	giá bán lẻ	
retinue	bầu đoàn	
retired official	trí sĩ	
return	giao hoàn	
return to one’s paternal home after the wedding day	quy ninh	
reveler	đãng tử	
reverse	đổi chiều	
revolving door	cửa quay	
rheology	lưu biến học	
rheumatism	thấp khớp	
rhymed	xuôi vần	
rice cereals	lúa má	
rice mixed with various cereals	cơm độn	
rice polisher	cối giã	
rice-seeding field	ruộng mạ	
riches	tài hóa	
rickshaw driver	phu xe	
ridge-beam	đòn dông	
riel (basic unit of currency)	riên	
right beside	sát ngay	
right now	liền bây giờ	
right wing	cánh hữu	
rightest	thiên hữu	
rime	tội phạm	
ring of light	quầng sáng	
rise high	ngút	
ritual sharing of the bridal cup of wine	hợp cẩn	
river and ferry	đò giang	
river estuary	hà khẩu	
road metal	đá sỏi	
road to honors	vân trình	
road-roller	xe lăn đường	
roam the world	phiêu bạt giang hồ	
roast peanuts	phá xa	
robot	máy tự động	
robotics	rô bô tích	
rock base	nền đá	
rock salt	muối mỏ	
rodent	gặm nhấm	
roentgen ray	tia rơn ghen	
roll of taxpayers	sổ đinh	
roof-top	nóc	
roommate	bàn đồng ngũ	
rope	nhợ	
rosewood	trắc	
rosy cheeks	đào kiểm	
rough draft	dự thảo	
roughly	đại để	
round-table conference	hội nghị bàn tròn	
routine	nếp cũ	
royal	triều thần	
royal citadel	hoàng thành	
royal decrees and ordinances	chỉ dụ	
royal palace	vương cung	
royal tombs and temples	lăng miếu	
rubber band	giây cao su	
ruby cup	quỳnh bôi	
rugged and inaccessible	hóc hiểm	
ruinous	khuynh gia bại sản	
rule of behavior	khuôn phép	
ruler of feminine education	nữ tắc	
rumor	miệng tiếng	
runner up	á hậu	
runway	phi đạo	
ruse	ngón chơi	
rush hour	giờ tan sở	
Russia(n)	Nga	
Russian (language)	tiếng Nga	
rustic	dã nhân	
rutch	nạng	
sabotage	phá ngầm	
sad	buồn bã	
safe	bình yên	
safety valve	nắp hơi an toàn	
safflower	hồng hoa	
sagebrush	ngải	
saint	thánh nhân	
salary grade or level	bậc lương	
salt marsh	diêm điền	
salted fish	muối cá	
salt-marsh	ngập mặn	
same	cùng	
sampling	lấy mẫu vật	
sanction	chế tài	
sandal	xăng-đan	
sandcrab	dã tràng	
Sanskrit studies	Phạn học	
sargasso (a kind of alga)	rau mơ	
sash	bao tượng	
satellite	vệ tinh	
satiated with food	bứ cổ	
satisfactory solution	giải quyết thỏa đáng	
satisfied (with)	mãn ý	
Saturday afternoon	chiều thứ bảy	
sauce	nước chấm	
savory	ý vị	
sawyer	thợ cưa	
say one’s name	xưng danh	
saying	cái câu	
scanner	máy quét hình	
scar	vết sẹo	
scarlet	hồng điều	
scary-looking	trông phát sự	
scattered and disorderly	lơ chơ lỏng chỏng	
schedule of an envoy	sứ trình	
schist	đá phiến	
scholar of talent	tú sĩ	
scholarly tradition	Nho phong	
school branch	phân hiệu	
school managing board	giám hiệu	
schoolmaster in charge of a school	trưởng giáo	
Science and Technology	Khoa Học và Kỹ Thuật	
scientific exchange	trao đổi khoa học	
scientific term	danh từ khoa học	
scold	la sát	
scope (on a firearm)	ống nhắm	
scorching	nóng như thiêu như đốt	
scowling	bầu bậu	
scrape round (in something hollow)	ngó ngoáy	
screw-cutter	bàn ren	
screw-wheel	bánh vít	
scurry here and there	nháo	
sea battle	thủy chiến	
sea danger	hải nạn	
sea gull	hải nga	
sea products	hải vật	
sea urchin	nhím biển	
sea-crab	cua bể	
seal	con dấu	
seam	đường chỉ	
seasick	say sóng	
seasonal rain	cam vũ	
seat (in a car)	chỗ ngồi	
seborrhoea	sài đẹn	
secluded	cô liêu	
second	nhì	
second floor	lầu hai	
secondary education	giáo dục trung học	
secondary school	trường trung	
second-in-command	phó tướng	
secret documents	tài liệu mật	
secret order	ám lệnh	
secret plan	bí kế	
Secret Service Agent	nhân viên mật vụ	
secretary	bộ trưởng	
secretary-general	tổng thư ký	
security council	cơ mật viện	
seduce	quyến dụ	
see bầu cử	bàu cử	
see nhân	nhơn	
seed	hạt giống	
seek men of great talent	cầu hiền	
segment	phân cắt	
seismology	địa chấn học	
selected excerpts	trích diễm	
self conceited	tự cao	
self maintained	tự duy trì	
self-guided	tự điều khiển	
selfless	vô vị lợi	
self-providing	tự đáp ứng	
sell definitively	đoạn mại	
semaphore	xê ma pho	
semi-feudal	bán phong kiến	
semi-public	bán công khai	
senate	thượng nghị	
send on a special mission	đặc sai	
sensibly thrifty	kiệm ước	
sensualist	duy giác luận	
sentence	từ cú	
sentimental	đa tình	
separation (of husband and wife)	li thân	
separation of death	tử biệt	
sequela	di chứng	
serious difficulties	khó khăn nghiêm trọng	
serious offence or crime	trọng tội	
Serpentarius	Thiên xà	
servant (s)	tôi đòi	
service chief	trưởng ty	
service number	binh số	
service provider	công ty cung cấp mạng	
servicemen (military)	quân nhân	
sesame oil	dầu vừng	
session	phiên	
set off (on a journey)	đăng trình	
set up altar	lập đàn	
seven-seven-six-eight word meter	song thất lục bát	
seventh	thứ bảy	
several dozen	hàng chục	
several times	đôi lần	
several years later	vài năm trước đó	
sewing	đường kim mũi chỉ	
sex	giới tính	
sex magazine	tạp chí tình dục	
sexual behavior	thái độ tình dục	
shade with parallel lines	gạch gạch	
shame	tu sỉ	
shameless	bơ bơ	
share the same border	giáp giới	
sharp or stabbing or piercing or throbbing pain	đau nhói	
sharp-eyed	nhanh mắt	
she speaks English well	cô ấy rất thạo tiếng Anh	
sheath	mo cau	
sheet music	bài đàn	
shield	khiên	
shift a debt over to	bắn nợ	
shift thoroughly	thẩm duyệt	
shinbone	xương chày	
shining black	đen nhánh	
shirt	áo cụt	
shoemaker	thợ giày	
shore	bờ	
short (time)	ngắn ngủi	
short jacket	áo cánh	
short term loan	món nợ ngắn hạn	
shortfall	thâm hụt	
short-limbed	ngũ đoản	
shot	cú sút	
should not	không nên	
show	tròi	
show irreverence to superiors	phạm thượng	
show off strength	diệu võ dương oai	
Showa Restoration	Thái Hòa Phục Hưng	
shrimp paste	mắm tôm	
shriveled	rúm	
shut one’s breath-keep absolutely quiet	ngậm họng	
shutter	cửa chớp	
Siam	Xiêm	
sickle	lưỡi liềm	
side	bên hông	
sidewalk	hè phố	
sight blade	đầu ruồi súng	
silkworm	tằm	
silver coin (used as a decoration)	ngân tiền	
similar and dissimilar	dị đồng	
simple life	đời sống đạm bạc	
sin	ác nghiệp	
since	kể từ	
since the beginning of last month	kể từ đầu tháng vừa qua	
since then	kể từ nay	
sincere feeling	chân tình này	
sinewy	săn gân	
sing a barcarolle	hò mái nhì	
single	duy nhất	
sino-Vietnamese medicine	thuốc ta	
siphon	xi phông	
sir (form of address)	bẩm ông	
sister-in-law (wife of one’s elder brother)	chị dâu	
sit up quickly	ngỏm dậy	
situation	cảnh ngộ	
size	qui mô	
skilful	cơ xảo	
skilled	già dặn	
skillful	tinh thạo	
skinny and pale	còm nhỏm còm nhom	
skirt	xiêm	
slab of lithographic stone	thạch bản	
slant line	đường xiên	
slave	nô bộc	
sleep (of a beautiful girl)	giấc hoa	
sleepless night	đêm trắng	
sleeve (of a garnment)	ống tay	
slender limbs	chân tai nhẳng	
slightly crack-brained	hâm hẩm	
slightly slanted	nghiêng nghiêng	
slimily wet	dấp dính	
slipper	păng túp	
sloping gently	dốc thoải	
slow (due to being fat)	ùn ỉn	
slow-witted	ngú ngớ	
slur	dấu luyến	
small	tị	
small bag	nải	
small business	tiểu thương	
small drum with a handle	trống lệnh	
small fry	thằng tép riu	
small screen	màn ảnh nhỏ	
small shrimp	tép	
small string	dợ	
smaller	nhỏ hơn	
smallpox	trái giống	
smart	bảnh bao	
smashed like the wrapping of a cracker (exploded)	tan như xác pháo	
smile and half close the eye	cười híp mắt	
smoky	ám khói	
smoothly	trót lọt	
snail shell	vỏ ốc	
snapper	cá hồng	
snatch	chụp giật	
sneak in and out	thậm thọt	
sniper	phục xạ thủ	
snow-flaked cake (sprinkled with powdered sugar)	bánh in	
so as to	cho được	
so much	biết mấy	
soaked	ướt đẫm	
soaking (wet)	đầm đìa	
soap suds	bọt xa phòng	
sobbingly	tức tưởi	
soccer team	đội bóng	
socialist doctrine	chủ nghĩa xã hội	
sociologist	nhà xã hội học	
sodium glutamate	bột ngọt	
sofa	ghế trường kỷ	
soft palate	cúa mềm	
soft white	trắng nõn	
soiled sullied	nhem nhúa	
solar month	tháng dương lịch	
solar system	thái dương hệ	
solderer	thợ hàn	
soldier	người lính	
soldier’s conical hat	nón dấu	
sole (of a shoe)	đế	
solicitude	thịnh tình	
solitary	tịch liêu	
solt pillow	gối êm	
some (or other)	nào đó	
someone else	ai khác	
something	một cái gì	
something easy to understand	điều dễ hiểu	
something strange	một chuyện lạ	
something that should be	điều đáng	
something very easy to do	một chuyện rất dễ làm	
sometimes	có lúc	
song	ca khúc	
sonorous	sang sảng	
soon	chẳng bao lâu	
soon to come	sắp sửa tới	
sophisticated stratagem	cao kế	
sorceress	cô đồng	
sort out carefully	gạn lọc	
soul brave soul	khí thiêng	
sound encoding	biên mã âm thanh	
sound of something falling	bộp	
sound of wood striking wood	lốc cốc	
sound someone out	ướm hỏi	
sour fish soup	canh giấm	
source of finances	nguồn tài chánh	
South Pole	Nam Cực	
Southeast Asia	Đông Nam Á Châu	
southern Buddhism	tiểu thừa	
souvenir	của tin	
Soviet Union	liên xô	
sow (which has had offspring)	nái sề	
space agency	cơ quan không gian	
spaghetti	mì ống	
spark-plug	bu gi	
speak glibly	nói hoẹt	
speak up	nói sòng	
speaker	diễn giả	
special	biệt tài	
special character	ký tự đặc biết	
special economic zone	đặc khu kinh tế	
special meeting	phiên họp đặc biệt	
specific weight	trọng lượng riêng	
spectacle	cảnh vật	
speech	bài diền văn	
spell (of code chart)	ghép vần	
sperm	tinh dịch	
sphere of influence	khu vực ảnh hưởng	
spica	tóc tiên	
spill	làm đổ	
spiral	trôn ốc	
spirit of stillborn boy or girl	con ranh	
spiteful	độc địa	
spleen	tỳ	
split-seam bottomed (children’s trousers)	hổng đít	
spoken word(s)	lời nói	
spokesperson	liên lạc báo chí	
spontaneous axis	trục tự sinh	
spooling	spun linh	
spot	vết	
spotless white	trắng muốt	
sprawl	nằm kềnh	
spray paint	sơn xịt	
spring (season)	xuân	
spring scenery	xuân quang	
square	hình vuông	
squares	kẻ ô	
squeeze with pliers	kìm cặp	
staff room	phòng văn thư	
stage performance	hát	
stainless alloy	hợp kim không rỉ	
stake out fields (said of a debtor)	cắm ruộng	
stalactite	vú đá	
stalk	cuống	
standard of living	mức sinh hoạt	
stand-up collar	cổ đứng	
start an engine	mở máy	
startup test run	nghiệm thu chạy thử	
state capitol	thủ phủ tiểu bang	
state of war	tình trạng chiến tranh	
static electric charge	điện tích tĩnh	
stationery with designs	tiên hoa	
statue	tượng	
steadfast solidarity	tình đoàn kết bền chặt	
steamer support	nồi đáy	
steaming hot rice	cơm sốt	
steep in water	lấp xấp	
stele	bi ký	
step-down transformer	máy hạ thế	
sternum	xương mỏ ác	
stick and fist (the two arts of fighting)	côn quyền	
sticky	nhầy	
stiflingly hot	nóng hầm hập	
still the same (way)	cũng vẫn vậy	
stingy	keo kiệt	
stirring rod	đũa khuấy	
stockbroker	người mua bán chứng khoán	
stomach pain or trouble	đau dạ dày	
storage area	khu vục dự trữ	
stored merchandise	hàng hóa tồn trữ	
stories of celebrities	liệt truyện	
straight	hạo nhiên	
straight into	thẳng vào	
straightforward and impartial	sòng phẳng	
strange development	biến chuyển lạ lùng	
strange phenomenon	quái tượng	
strange situation	tình trạng kỳ quặc	
stranger	hàng xứ	
strategic map	bản đồ chiến lược	
stratigraphy	địa tầng học	
streetcorner	góc đường	
stress	ứng lực	
strict and clear	nghiêm minh	
strict management	quản lý chặt chẽ	
stringy meat	bạc nhạc	
strong and robust	hùng kiệt	
strong man	kiện nhi	
strong wind	gió mạnh	
strongly	chịt	
stub	tồn căn	
student learning abroad	lưu học sinh	
students	đào lý	
stuffed	đầu nhóc	
stumble or stagger along	choại	
stupid and base	ngu hèn	
stupified	đứng đơ	
subaltern	thuộc viên	
subdignitaries (Cao Dai)	Chức Việc	
subject	nội dung	
subject of study	khoa	
submit an application	đưa đơn	
subordinate	tôi tớ	
subsidence	lún sụt	
subtle	tế nhị	
successful examinee at village level	cống sinh	
sudden	bất thình lình	
sugar candy	đường phèn	
sugar-coated ground-nuts	mức lạc	
suggestibility	ám thị tính	
suicide troops	quân cảm tử	
suitable alliance	môn đăng hộ đối	
sullying	nhuốc	
summer holiday	nghỉ hè	
sun and planet gear	bộ bánh xe ba cấp	
sunken eye	trõm	
sunny	nắng	
suntanned	cháy nắng	
superlatively	nhất hạng	
supermarket	siêu thị	
superpower (country)	siêu cường quốc	
supported by	dưới sự yểm trợ	
supposing	giá phỏng	
suprarenal gland	tuyến thượng thận	
sure	chắc mẩm	
surely	ắt	
surgeon	phẫu thuật viên	
surprised	giựt mình	
surrender	lai hàng	
survey land (with a view to a new land policy)	kiến điền	
suspect (in a crime)	nghi phạm	
swaggering	nghênh ngang	
swallow up	nuốt trửng	
swear brotherhood	kết nghĩa	
Sweden	Thụy điển	
sweet pepper	quả ớt tây	
sweetheart	bạn lòng	
sweetmeat	quà bánh	
sweet-scented	thơm ngạt ngào	
swell	sóng lừng	
swelling	ung độc	
swiftly	te	
swimming pool	bể bơi	
swing	xích đu	
swipe	nẫng	
swollen	căng phồng	
symbol	ký hiệu	
syphilis	giang mai	
systems analysis	phân tích hệ thống	
table fan	quạt bàn	
table tipping (Cao Dai)	xây bàn	
tablet	viên nén	
taboo name	tên húy	
taciturn	lầm lỳ	
Taiwan declared its full support	Đài Loan tuyên bố hoàn toàn ủng hộ	
take a siesta	nghỉ trưa	
take one’s sick leave	nghỉ ốm	
take pains	lặn lội	
talent	tài năng	
talk profusely (about)	cao đàm	
talk to oneself	bụng bảo dạ	
tall (of stature)	cao lớn	
tall and thin	lòng khòng	
Tan Son Nhat (airport)	Tân Sơn Nhất	
tang prosody	Đường luật	
tango	tăng gô	
tapering	thon thon	
taro	môn nước	
taskbar (Windows)	thanh công việc	
taste	khẩu vị	
tastily rich	ngậy	
tax evasion	tội trốn thuế	
taxes	khoản thuế	
tea buds	chè hột	
teacher and pupil	sư sinh	
teacher’s teachings	kim thanh	
teaching aid	học cụ	
teal (bird)	mòng	
tea-pot	ấm chuyên	
tears trickle out	rớm rớm nước mắt	
technical degree	bằng cấp chuyên môn	
technical training	huấn luyện kỹ thuật	
technology (as a field of study)	kỹ thuật học	
telecommunications system	hệ thống viễn thông	
telephone	cái điện thoại	
telephone service	dịch vụ điện thoại	
telescopic	ống lòng	
television channel	kênh truyền hình	
temper	nung đúc	
temperate zone	ôn đới	
temple in the clouds	am mây	
temporary	nhất thời	
ten minutes	mười phút đồng hồ	
ten thousand happinesses	vạn phúc	
tenancy farming	làm rẽ	
tender days	ngày xanh	
tension	vụ giằng co	
tenth-month rice	gạo mùa	
term for a mandarin	quan phụ mẫu	
termagant	quạ cái	
terra-cotta (china) seat	đôn	
territorial dispute	tranh chấp lãnh thổ	
terrorism	nạn khủng bố	
test positive (for AIDS)	huyết thanh dương tính	
testis	dịch hoàn	
tetrahedron	tứ diện	
thank	thù tạ	
thank respectfully	kính tạ	
Thanksgiving (U.S. holiday)	lễ tạ ơn	
that business will perhaps be settled	việc ấy nhắm chừng cũng xong	
that direction	đằng kia	
That house is made of wood	cái nhà ấy làm bằng gỗ	
that matter will be settled anyway	việc nớ sẽ xong thôi	
that news caused a stir in public opinion	tin đó làm dư luận nhôn nhao	
that person	người kia	
That was an unfortunate thing	đó là điều bất hạnh	
that’s all	thôi mà	
that’s right	đúng như vậy	
thatched cottage	nhà tranh	
thatched roof	mái gianh	
the (French) foreign legion	lê dương	
the (World) Olympic Games	Thế Vận Hội	
the application deadline	hạn chót nhận đơn	
the ardor of passions	lửa tình	
the astronomical service	khâm thiên giám	
the authorities	giới hữu trách	
the bird was caught in a snare	chim sa vào bẫy	
the bitter sea	bể thảm	
the child begins to learn to speak	đứa trẻ bắt đầu tập nói	
the communist forces were surrounding Saigon	quân cộng sản đang bao vây Sài Gòn	
the congress was dissolved	quốc hội bị giải tán	
the crowd was in a stir	đám đông nhộn nhạo	
the dead and injured	thương vong	
the discus throw	ném đĩa	
the edge of town or city	ven đô	
the eight tactical dispositions	bát trận đồ	
the eldest son	trưởng nam	
the end of the month	nguyệt tận	
the end of Vietnam as we know it	chấm dứt Việt Nam như chúng ta đang thấy	
the essential point	yếu điểm	
the face of the earth	mặt đất	
the farming profession	nghiệp nông	
the fire has just been kindled	lửa mới nhem	
the first and fifteenth of a lunar month	sóc vọng	
the five punishments (death	ngũ hình	
the following summer	mùa hè kế đó	
The Four Essential Virtues	tứ đức	
the frame of a fishing net	gọng vó	
the future is bright	tương lai là tươi sáng	
the god of sun	đông quân	
the good people	các nàng tiên	
the heaven’s net	lưới trời	
the horns of a stag	lộc giác	
the human rights debate	thảo luận về nhân quyền	
the impression of a seal	ấn tích	
the issue in question	vấn đề được đặt ra	
the king and one’s parents	quân thân	
the last few months	vài tháng vừa qua	
the latter half of the 20th century	nửa sau của thê ký 20	
the little child ran light-footedly	em bé chạy nhon nhỏn	
the married couple	hai vợ chồng	
the medical world	giới y khoa	
the more the better	đa đa ích thiện	
the most necessary thing	cái cần nhất	
the New Order for greater East Asia	khối đại đông á	
the nine grades of mandarin system	cửu phẩm	
the old man in the moon	nguyệt lão	
the other side (of a coin	bề trái	
the people of those times	người dân thời đó	
the person of the emperor	long thể	
the plaintiff and the defendant	nguyên bị	
the pole-star	bắc thần	
the present and the past	kim cổ	
the press	báo chí	
the prime of life	tráng niên	
the proof of the pudding is in the eating	thui ra mới biết béo gầy	
the red race	hồng chủng	
the Renaissance	thời đại phục hưng	
the right time	thời điểm thích hợp	
the rustle of leaves	tiếng lá sột soạt	
the scriptures	thánh thư	
the sense organs	cảm quan	
the signs of the heavenly stems and of the earthly branches	can chi	
the sky net	thiên la địa võng	
the spacious seas	biển mênh mông	
the spring	dương xuân	
the struggle for democracy	tranh đấu cho dân chủ	
the ten commandments (of Christianity)	thập giới	
the thing she liked the most	thứ nàng ưa nhất	
the three beliefs (Buddhism	tam giáo	
the three duties of a man (to king	tam cương	
the time	thời trước 1975	
the Trung sisters	hai bà Trưng	
the twelve earth’s stems cyclical terms	thập nhị chi	
the two sisters are rather like each other	hai chị em na ná nhau	
the West	Tây Âu	
the wood-blocks of folk woodcuts	mộc bản tranh dân gian	
the world powers	liệt cường	
the yolk of colonialism	ách thực dân	
theater troupe	ban kịch	
then	bất giờ	
theorem	định lý	
theorician	nhà lí luận	
there are a lot of people	có lắm người	
there are many reasons for	có nhiều lý do khiến	
there is	có nơi	
there is no one	đâu có ai	
there is none	không có thứ nào	
there was a time	có một lúc	
there was no one at all	chẳng có ai cả	
there’s only me	có mình tôi	
thereupon	tiếp liền	
thermionic emission	phát nhiệt xạ	
thermometer	hàn thử biểu	
thermoscope	nhiệt nghiệm	
these (last) few days	mấy bữa rầy	
they follow the same profession	chúng nó cùng làm một nghề với nhau	
thicket	bùm tum	
thickness	bề dày	
thin	gầy	
thin blanket	chăn đơn	
thin goldleaf	vàng quỳ	
thin tissue paper	giấy quyến	
things can be said different ways at different times	cái lưỡi không xương nhiều đường lắt léo	
think to oneself	nghĩ bụng	
thin-skinned sweet orange	cam giấy	
this (line of) reasoning is unsound	lập luận này không vững	
this clock doesn’t run correctly	đồng hồ này không chạy đúng	
this is the last time	đây là lần cuối cùng	
this is unrealistic	như vậy là không thực tế	
this moment	giây phút này	
this much	ngần ấy	
this ointment is for external use only	thuốc mỡ này chỉ dùng ngoài da	
this past Monday	ngày thứ hai vừa qua	
this thing	cái này	
this week	trong tuần này	
this year	cái năm này	
those guys	bọn chúng nó	
though	tuy là	
thread of an electric bulb	sợi đèn	
three autumns	ba thu	
three generations	tam đại	
three responsibilities (women’s emulation movement)	ba đảm đang	
three-fourths	ba phần tư	
three-way	tay ba	
thremosphere	nhiệt quyển	
throne	ngai rồng	
through train	tàu suốt	
throughout	qua nhiều thế kỷ	
throughout human history	suốt lịch sử nhân loại	
throw out vague innuendoes	nói trổng	
thud	phịch	
thugs	giặc cướp	
thump thump	thịch thịch	
thunderstruck	mất hồn	
thyroid gland	tuyến giáp trạng	
Tibetan (person)	người Tây Tạng	
tie all four limbs	trói tôm	
Tien Tsin	Thiên Tân	
tiger	con hổ	
tigers and panthers	hùm beo	
till the end of one’s life	lụn đời	
time(s)	thời	
times (as in New York Times)	thời báo	
timorous and artful	nhẻ nhót	
tinfoil	tấm thiếc	
tipsy	ngà ngà say	
tire and tube	săm lốp	
tired of	chán chường	
tit for tat	ăn miếng trả miếng	
to (be on	đình công	
to (build or make a) nest	làm tổ	
to (feel) regret	ân hận	
to (raise an) alarm	cảnh cáo	
to (take the) lead	cầm đầu	
to a certain extent (measure	đến một mức nào đấy	
to abolish	bãi vỏ	
to abstain (from a vote)	miễn bỏ phiếu	
to accelerate	tăng tốc độ	
to accept a result	chấp khận kết quả	
to accompany	đi cùng với	
to acquit	trắng án	
to act deaf	giả điếc	
to add in	chêm	
to add tone marks	bỏ đấu	
to administer	cai trị	
to admire greatly	phục sát đất	
to admit into the hospital	chuyển qua bệnh viện	
to adore	chiêm bái	
to advise (against something)	can ngăn	
to advocate	chủ trương	
to agree	hòa hợp	
to aim a gun at	nhắm cây súng vào	
to allocate	cấp phát	
to allude	nói bóng gió	
to also have to	cũng phải	
to alternate	giao lưu	
to amend the constitution	tu chính hiến pháp	
to announce	loan báo	
to annul	triệt tiêu	
to answer right away	trả lời ngay	
to ape	a dua	
to appeal to	kêu gọi nhân dân	
to appear and disappear alternately	thấp thoáng	
to appease	xoa dịu	
to apply the brake	bóp phanh	
to apprehend	lĩnh hội	
to appropriate	chiếm giữ	
to approve a request	chấp đơn	
to argue about the price	kì kèo	
to arrange	bố trí	
to arrive	đến nơi	
to arrive late	đến chậm	
to ask a few questions	hỏi vài câu	
to ask for help	cầu cứu	
to ask permission	cáo lui	
to assemble	qui tụ	
to assist in teaching	trợ giáo	
to astonish	sửng sốt	
to attack by surprise	tập kích	
to attempt	nhấp nhứ	
to attend a banquet	ăn tiệc	
to attend a feast	ăn cỗ	
to auction	đấu giá	
to avenge	báo oán	
to avoid the human rights issue	tránh né vấn đề nhân quyền	
to awake from one’s dream	tỉnh mộng	
to babble	bí bô	
to back up	trùn bước	
to banter	đú đơn	
to bare	phanh phui	
to barter	chác	
to be ~ ing	đang ngày một	
to be a citizen of	có quốc tịch	
to be a good worker	làm việc hăng say	
to be a killjoy	phá bỉnh	
to be a member	có châu	
to be a prostitute	buôn son bán phấn	
to be a stirrer	xui nguyên giục bị	
to be able to	đặng	
to be able to speak fluent Chinese	nói được tiếng hoa lưu loát	
to be absolutely silent	phắc	
to be absorbed into	nhập vô	
to be accused	bị cáo buộc	
to be adversely affected	bị ảnh hưởng tai hại	
to be all over	xong chuyện	
to be an opium addict	bẹp tai	
to be angry with oneself	giận mình	
to be arrested	bị bắt	
to be asked about (something)	được hỏi về	
to be attentive	chăm chú	
to be born	sinh	
to be born in the year of the horse	tuổi con ngựa	
to be born in the year of the rat	tuổi con chuột	
to be bothered	bị dằn vặt	
to be buck toothed	vẩu răng	
to be busy	có chút việc	
to be called	có tên là	
to be caught or entangled	vướng mắc	
to be choked by tears	nghẹn ngào	
to be commanded by	chỉ huy bởi	
to be completely out of breath after a long run	chạy xa đứt cả hơi	
to be connected to	có liên hệ với	
to be cracked	bị nứt	
to be critical of oneself and one’s faults and	tự phê bình	
to be crowned champion	đăng quang vô địch	
to be deep in religious contemplation or meditation	thiền định	
to be degraded	bị giáng xuống	
to be different	có khác	
to be discriminated against	bị kỳ thị	
to be dispersed or scattered	xiêu tán	
to be down (shades	phủ xuống	
to be dreaming	mơ ngủ	
to be drowned	chết chìm	
to be educated into a good person	được dạy dỗ nên người	
to be entertained	giải trí	
to be fond of	gắn bó	
to be forbidden	bị cấm đoán	
to be frank	bộc tuệch bộc toạc	
to be full of (natural) resources	đầy tài nguyên	
to be greedy for	hám	
to be hand up	quẫn bách	
to be harmed	suy suyển	
to be heavily polluted	bị ô nhiêm nặng	
to be ill	đau yếu	
to be in average health	có tạng trung bình	
to be in collusion	thông đồng	
to be in good health	mạnh giỏi	
to be in rags and tatters	xạc xài	
to be in serious	trong tình trạng nguy kịch	
to be in the clouds	chín tầng mây	
to be in the hospital	nằm nhà thương	
to be ineffective	vô hiệu lực	
to be joined in marriage	sánh duyên	
to be just asking	chỉ hỏi vậy thôi	
to be large	thạc	
to be leaked (report	bị rò rỉ	
to be like one’s father	giống tính cha	
to be lucky	gặp may	
to be missing (of people)	bị mất tích	
to be moved by a spectacle	xúc cảnh	
to be obliged	buộc lòng	
to be of a kind	thuộc loại	
to be of the same generation (age-group)	cùng một nhòng	
to be on duty	trực nhật	
to be on intimate terms with sb	dan díu	
to be on the side of	ở bên cạnh	
to be only symbolic	chỉ có tính cách tượng trưng	
to be over-confident	tự tin quá	
to be persecuted	bị hành hạ	
to be plunged in sorrow or melancholy	trầm uất	
to be political	có tính chất chính trị	
to be poor	hốn khổ	
to be pregnant	chửa	
to be pressured	bị áp lực	
to be ready	trực	
to be relieved	đỡ lo	
to be right	nói đúng	
to be ruled	bị trị	
to be scared	chột dạ	
to be scared shitless	sợ đến độ ỉa cả trong quần	
to be seized with panic or terror	mất vía	
to be sentenced in absentia	xử khiếm diện	
to be sentenced to life in prison	bị tuyên án tù chung thân	
to be shameless	bợ	
to be sick	mắc bệnh	
to be social	hiếu giao	
to be sorry	hối tiếc	
to be studious	hiếu học	
to be sufficient	thấm tháp	
to be surrounded and captured	vây bắt	
to be temperate	ăn uống điều độ	
to be the king	làm vua	
to be tormented by a deep longing	nhớ da diết	
to be trapped	bị kẹt lại bên trong	
to be used to someone’s voice	bén tiếng	
to be valid	có hiệu lực	
to be very careful	cẩn thận tối đa	
to be very fond of	sính	
to be very surprised	ngạc nhiên vô cùng	
to be worried and sad	lo buồn	
to be wrong	có sao	
to beat a drum	đánh trống	
to beat somebody to death	đánh chết	
to beat wildly	đập thình thịch	
to become	biến thành	
to become angry	nổi giận	
to become immortal	hóa ra bất tử	
to become wide-eyed	trợn mắt lên	
to beguile by sweet promises	dỗ ngọt	
to behold	ngắm	
to believe or think (that) the moon is	trông gà hóa cuốc	
to belong to a different tradition	thuộc truyền thống khác	
to besiege	bay vây	
to bid for	đấu thầu	
to bind (a hardback book)	đóng bìa	
to bite off more than one can chew	vung tay quá trán	
to blend	pha trộn	
to blink	nháy mắt	
to block	chận đường	
to blow the horn	bóp còi	
to board at someone's house	ở trọ nhà ai	
to boil one’s laundry	nấu quần áo	
to bomb	oanh kích	
to bore easily	dễ chán	
to both sides	sang hai bên	
to bow one’s head	cúi đầu xuống	
to break a silence to burst out	phá tan sự im lặng	
to break off	gián đoạn	
to break off a friendship with	hết thân với	
to break one’s promise	vi ước	
to break sb’s heart	xé nát trái tim	
to break the seal of a letter	hủy dấu niêm bức thư	
to break up	phân hủy	
to breath	hô hấp	
to breathe in	thở vào	
to breathe one’s last	tắt thở	
to breed	nuôi tầm	
to bribe	hối lộ	
to bring	na	
to bring about the desired result	đem đến kết quả mong muốn	
to bring back to life	phục hoạt	
to bring in	nhập	
to bring out a new look	đưa ra một bộ mặt	
to bring up	cúc dục	
to browbeat	nạt nộ	
to brush or touch the ground	quét đất	
to build (up)	xây đắp	
to bulge out	cộm lên	
to bump into each other	đâm sầm vào nhau	
to burn at the stake	hỏa thiêu	
to burn up	nóng rang	
to burst out	trổ ra	
to bury together	hợp táng	
to busy oneself with	mải miết	
to buy a house	cất nhà	
to buy goods	cất hàng	
to calculate	tính toán	
to call	mệnh danh	
to call on	thăm	
to call oneself	tự nhận mình là	
to call the police	gọi cho cảnh sát	
to camp	đồn trú	
to care for	bảo anh	
to carry (heavy things)	khuân vác	
to carry a gun on one’s hip or waist	dắt cây súng trong bụng	
to carry at the ready	mang sẵn	
to carry home	chở về	
to carry out a duty	thi hành một nghĩa vụ	
to carry out orders	thừa hành lệnh	
to carry with both hands	bưng	
to catch	trúng	
to catch fire	phát hỏa	
to categorize	xếp hạng	
to cause a disturbance	náo	
to cause a sin	gây ác nghiệp	
to cause disturbances	tác loạn	
to cease	bẵng	
to celebrate a birthday	ăn mừng sinh nhật	
to centralize (administrative powers)	tập quyền	
to certify	chứng thực	
to change channels	chuyển kênh	
to change completely	thay đổi hẳn	
to change money	đổi tiền	
to change one’s tactics	trở quẻ	
to change to or into something	hóa phép	
to chase	duổi	
to cheat in commerce	buôn gian bán lận	
to chew briefly or hastily	trệu trạo	
to choose	tuyển chọn cẩn thận	
to chop up (into very small bits)	bằm	
to circulate	tuần hoàn	
to claim something that is not one’s own	nhận vơ	
to classify	phân loại	
to clean up	dọn sạch	
to climb into bed	leo giường	
to cling to life	tham sinh	
to clip	cắt xén	
to close (but not completely)	khép hờ	
to close a book	gập sách lại	
to close the door	đóng cánh cửa	
to collect garbage	hốt rác	
to collude	câu kết	
to come down here	xuống đây	
to come from Japanese	bắt nguồn từ tiếng Nhật	
to come out	bốc ra	
to come to	lai tỉnh	
to come to an end	kết liễu	
to comfort	vỗ yên	
to commit (a crime)	can tội	
to commute	giảm án	
to compete	chạy đua	
to complain about the administration	phàn nàn về hành chánh	
to complicate	làm phức tạp thêm	
to comply with	tuân lệnh	
to compose	hành văn	
to conceal	che khuất	
to conceal troops	ém quân	
to condole with (someone)	phân ưu	
to confess the truth	thú thật	
to confine oneself	chôn chân	
to confirm	xác định	
to confront China	đối chất với Trung Quốc	
to conjugate	liên hợp	
to consecrate	tấn phong	
to consider	coi là	
to consist of	bao gồm	
to consolidate a relationship	củng cố sự liên hệ	
to consume	tiêu thụ	
to continue	kế tục	
to continue to tell (a story)	kể tiếp	
to contract a bad habit	nhiễm một thói xấu	
to contribute money	đóng góp tiền	
to control a machine remotely	khiến một máy từ xa	
to converse	chuyện trò	
to convert	cảm hóa	
to convey	vận tống	
to convict	xử tội	
to coo	gù	
to cooperate with the government	cộng tác với chính quyền	
to correct	biện chính	
to corrupt somebody’s morals	tha hóa	
to cost much	tốn nhiều	
to count oneself completely powerless	chịu phép	
to court	ve vãn	
to cover up	bao phủ	
to cram	ních	
to crawl around	bò lê bò la	
to create a danger	gây nguy hại	
to create difficulties	bới việc	
to create instability	tạo bất ổn	
to create understanding	gây sự cảm thông	
to creep	loi ngoi	
to criticize continuously	liên tục chỉ trích	
to croak	oác oác	
to cross	bắt tréo	
to cross out	gạc	
to crumb	bẻ vụn	
to crush out a cigarette	dụi điếu thuốc lá	
to curl one’s tongue	uốn lưỡi	
to cut	chém	
to cut down a tree	chặt cây	
to cut into thin slices	lạng	
to cut or mow grass	làm cỏ	
to dam (up)	đắp đập	
to dare (to do sth)	dám	
to dazzle	láo mắt	
to deal drugs	buôn bạch phiến	
to death	chết xác	
to declare	khai báo	
to decline	luân lạc	
to deduce	suy diễn	
to defer	chiều ý	
to defy	phớt lờ	
to degrade	suy biến	
to deliberate	nghị luận	
to deliver a speech	diễn thuyết	
to demand	đòi hỏi	
to demand a gift (from a future bridegroom)	thách cưới	
to demobilize the troops	phục viên	
to denote	chỉ rõ	
to denounce	ton hót	
to deodorize	khử mùi	
to deploy	triển khai	
to deposit	lắng	
to descend to earth	giáng phàm	
to deserve	đáng lưu ý	
to desire strongly	đam	
to detain	giam giữ	
to devour one’s meal	ăn ngấu nghiến	
to die	ăn đất	
to die at middle age	nửa đời nửa đoạn	
to die early	chết sớm	
to die miserably	bỏ xác	
to die unexpectedly	chết bất ngờ	
to dig	đào xới	
to dip something in a liquid	nhúng vật gì vào nước	
to disagree	lục đục	
to disappear	biệt dạng	
to disarm	tháo gỡ	
to discover or find out that	khám phá ra một điều là	
to discuss	biện thuyết	
to disguise oneself	cải dạng	
to dismiss	bãi dịch	
to dismiss somebody from his duties	miễn nhiệm	
to display	biểu dương	
to display the talons	nhe nanh múa vuốt	
to dissect	lóc	
to disturb	phá rối	
to dive under the water	hụp	
to divide and rule	chia để trị	
to divulge secret news	tiết lộ tin tức mật	
to do a job	làm nghề	
to do an exercise or homework or lessons	làm bài	
to do each other favors	làm ơn cho nhau	
to do housework	làm việc nhà	
to do something thoughtlessly and immediately	văng tê	
to do that	làm như thế	
to download	nạp xuống	
to drag out	cà kê	
to drain	rút mủ	
to draw cards	bốc bài	
to draw up a net	kéo lưới	
to drill for oil	khoan dầu	
to drink coffee	uống cà phê	
to drink socially	đối ẩm	
to drip	rỉ từng giọt	
to drive a car	lái chiếc	
to drive after	đuổi theo	
to drop by parachute	thả dù	
to drown	chết ngộp	
to dry	hong	
to dye	nhuộm	
to earn one’s living or one’s bread or one’s daily bread	độ nhật	
to eat (meat	ăn vã	
to eat lunch	dùng bữa trưa	
to eat remains	ăn thừa	
to eat someone else’s ration	ăn ghẹ	
to eat uncooked food	ăn sống	
to echo	hưởng ứng	
to edit	san nhuận	
to efface	xóa nhòa	
to electroplate	mạ điện	
to embroider	tô vẽ	
to emit	phát xuất	
to encircle	siết lấy	
to encourage	khuyến	
to encroach	lấn áp	
to endure	nhẫn nại	
to endure or suffer hardship	chịu cực	
to enjoy	thưởng thức	
to enlist	tòng quân	
to enrich	làm phong phú hóa	
to enroll students	tuyển sinh	
to enter	du nhập	
to enter into meditation	tham thiền	
to entertain	khoản đãi	
to entrust	giao	
to erupt	sùi	
to escape a situation	thoát khỏi tình trạng	
to escape death	thoát chết	
to escape from the ordinary	giải thoát ra ngoài mọi giới hạn tầm thường	
to establish in advance	tiên lập	
to esteem	ham chuộng	
to evacuate	tản cư	
to examine	khảo	
to exchange money	chuyển tiền	
to excrete	bài xuất	
to execute (a person)	hành quyết	
to exhibit	biểu diễn	
to exile	lưu đày	
to expand one’s borders	mở mang bờ cõi	
to expect favors from above	ngưỡng vọng	
to experience hardships	lăn lóc	
to explain clearly	giải thích rõ	
to expose	vạch	
to express approval	tỏ ra đồng ý	
to extend	thò	
to extinguish	dập tắt	
to extort	tống tiền	
to fail in one’s (moral) duty	lỗi đạo	
to fake illness	bệnh giả	
to fall back	ngừng lại	
to fall into a trap	trúng kế	
to fall with a flop	rơi đánh bẹt một cái	
to farm	cầy cấy	
to fart	đánh rắm	
to fasten	ràng	
to fasten together	kết	
to fear	e lệ	
to feel	cảm thấy say xe	
to feel a little sorry	thấy hơi hối hận	
to feel angry at	cảm thấy giận	
to feel awkward	sượng mặt	
to feel grateful	thấy biết ơn	
to feel nauseated	cảm thấy buồn nôn	
to feel sorry for	thương cảm	
to feel tired	cảm thấy mệt mỏi	
to feign defeat	trá bại	
to feign illness	cáo bịnh	
to fight	cãi lộn	
to fight for supremacy	tranh hùng	
to fight with somebody over power	tranh quyền	
to fill out	bắt gió	
to finance a house	tài trợ nhà	
to find fault	xoi móc	
to find out	tìm ra	
to fire (sb from a job)	đuổi cổ	
to fire warning shots	bắn cảnh báo	
to fit	ráp	
to fix	cặm	
to flare up violently	bột khởi	
to flash up	lóe lên	
to flee	bôn đào	
to fleece (customers)	cứa cổ	
to flinch from	nao núng	
to float in one’s head	lẩn quẩn trong đầu	
to flock out	túa	
to flow (out)	tiết	
to flow back	cuộn trôi ra	
to flutter	hồi hộp	
to fly	bay lượn	
to follow after	rượt	
to follow in one’s footsteps	theo chận	
to follow suit	làm theo	
to force (a woman) to marry	ép duyên	
to force a smile	cười gượng	
to foretell	đoán trước	
to forget oneself	quên mình	
to form a crowd	xúm đông	
to form an association	lập hội	
to fortify the kidneys (tonic)	bổ thận	
to frequent	lui tới	
to frighten someone	làm e sợ	
to frustrate	phá hỏng	
to fuck	đéo	
to gamble	bài bạc	
to gasp for breath	thở hổn hển	
to gaze at	chú mục	
to get a hotel room	mướn khách sạn	
to get angry	nổi xung	
to get close to	áp sát vào	
to get excited	mừng rơn lên	
to get into a car	lên xe	
to get stale and smell	thiu thối	
to get through current problems	vượt qua những khó khăn hiện nay	
to get up late	thức dậy trễ giờ	
to get used to sth	cho quen	
to give a banquet	thết tiệc	
to give a warranty to	bảo hành	
to give birth to	sinh hạ	
to give hands to	góp sức	
to give me	cho tao	
to give one’s last will	trối trăng	
to give orders	truyền bảo	
to give someone a lesson	sửa lưng	
to give up	tung hê	
to give up one’s place	nhường chỗ	
to glance at	liếc mắt nhìn	
to glean (corn)	mót	
to go (of a bride to her husband’s house)	vu quy	
to go abreast	song hành	
to go across	đi ngang	
to go along something	men theo	
to go and to come back	khứ hồi	
to go back	đi trở lại	
to go do the laundry	đi giặt đồ	
to go down on one’s knees	quỳ gối	
to go home early	đi về sớm	
to go in for trade	đi buôn	
to go off by accident	cướp cò	
to go on a pilgrimage	hành hương	
to go on holiday	nghỉ mát	
to go out	ra khỏi	
to go shopping	đi mua sắm	
to go through an ordeal	trải qua một thử thách	
to go to waste	bị phí	
to go towards	đi tới	
to go up for an examination	dự thi	
to go up to one’s room	lên phòng	
to go which way	đi lối nào	
to grab tightly	nắm chặt	
to graze to scratch slightly	sướt	
to grind	giã	
to grind one’s teeth	nghiến răng	
to grope	mò mẫm	
to growl	gườm	
to hail curses on somebody	chửi như tát nước	
to hand back	trao trả	
to hand over the watch	giao ca	
to hang (someone)	treo cổ	
to hang on	bám víu	
to hang up	giăng	
to happen	xảy ra	
to hate	hiềm khích	
to have a bloody nose	chảy máu mũi	
to have a condition	có điều kiện	
to have a faint smell	thoang thoảng mùi	
to have a fit	lên cơn	
to have a glib tongue	béo mép	
to have a good time	vui chơi	
to have a high opinion of	có cảm tình cao	
to have a large	ăn khỏa	
to have a load taken off one’s mind	nhẹ nợ	
to have a name	mang danh hiệu	
to have a special place	có một vị trí đặc biệt	
to have ability	có khả năng	
to have an average level of education	trình độ giáo dục trung bình	
to have an unbroken sleep	yên giấc	
to have back pain	bị đau lưng.	
to have been a long time (since sth)	đã lâu	
to have clear proof	có bằng chứng rõ rệt	
to have difficulty finding or have no customers	ế thiu	
to have feet of clay	tốt mã dẻ cùi	
to have just finished speaking	rời miệng	
to have many disadvantages	có nhiều bất tiện	
to have much	có nhiều dầu khí	
to have news	có tin tức	
to have no (more) hope	hết có hy vọng	
to have no voice in a matter	bé họng	
to have one’s feet shackled	chân bị cùm	
to have or run a temperature	nóng đầu	
to have reverence	ăn nhằm	
to have sufficient proof	có đủ bằng chứng	
to have to go to work early	phải đi làm sớm	
to heal (a wound)	lành	
to hear (the sound of) a shot	nghe tiếng nổ	
to hear the sound of	nghe tiếng	
to help (for)	dùm	
to help one’s friends	hỗ trợ bạn	
to hesitate	chàng màng	
to hide	giấu giếm	
to hinder	gàn	
to hit with a hammer	búa bổ	
to hold a ceremony	làm lễ	
to hold each other’s hands	nắm tay nhau	
to hold one’s face and cry	ôm mặt khóc	
to hold one’s sides (with laughter)	ôm bụng	
to hold out both hands	dang hai tay ra	
to hold tight	ghì chặt	
to hold US citizenship	mang quốc tịch Mỹ	
to hop	lò kò	
to hope for	mong mỏi	
to hotly debate	bàn cãi sôi nổi	
to hover between life and death	sống dở chết dở	
to hunt for	nã	
to imitate	mô phỏng	
to implore	van lạy	
to imprison	hạ nhục	
to improve the human rights situation	cải thiện tình trạng nhân quyền	
to include the English terms	kèm tiếng theo những danh từ	
to increase considerably	lên một mức đáng kể	
to induce or hasten menstrual flow	điều kinh	
to influence	có ảnh hưởng	
to inherit	kế thừa	
to insert a key in a lock	tra chìa vào khoá	
to inspect	kinh lý	
to insulate	cô lập	
to insult indirectly	chửi đổng	
to interfere with	xen vào	
to interrogate	căn vặn	
to interrupt	làm gián đoạn	
to interview	phỏng vấn	
to inverse	nghịch đảo	
to invest money in	bỏ tiền đầu tư vào	
to invite for form’s sake	mời lơi	
to involve	dính líu	
to issue a resolution	ra nghị quyết	
to jam (a radio broadcast	phá sóng	
to jest	rỡn	
to join with	kết thân với	
to jostle	hích	
to judge (guilt or innocence)	xét tội	
to keep asking	tiếp tục hỏi	
to keep company with	hầu chuyện	
to keep in close touch with	đi sâu đi sát	
to keep repeating oneself	như chó nhai giẻ rách	
to keep the Buddhist commandments	trì giới	
to kick somebody upstairs	đá hất lên	
to kidnap	bắt cóc	
to kill two birds with one stone	nhất cử lưỡng tiện tục ngữ	
to kiss	hôn	
to knock against	va quệt	
to knock out (in boxing)	đo ván	
to know it but to be forced to keep silence	biết đấy mà phải ngậm tăm	
to know that	biết là	
to know very clearly	biết rõ trắng đen	
to lament	than thở	
to land (plane)	hạ cánh	
to last	kéo dài trong nhiền thập niên	
to last through the winter (food	cung ứng suốt mùa đông	
to launch a missile	phóng phi đạn	
to launder money	rửa tiền	
to lead (a crowd	dẫn đầu	
to lead to a dead end	đưa vào ngõ cụt	
to leap out	nhảy ra	
to learn a lesson by heart	bài học thuộc lòng	
to leave one’s country	bỏ quê hương	
to leave one’s homeland	rời quê hương	
to leave something unfinished	bỏ dở	
to leave the office	bỏ sở	
to lessen	bớt	
to let out	buông ra	
to liberate	khai phóng	
to lie down for a short while	ghé lưng	
to lie on	nằm trên	
to lie within one’s territorial waters	nằm trong hải phận	
to lift	bứng	
to light	mồi lửa	
to light a campfire	đốt lửa trại	
to limp	bước thấp bước cao	
to list some points	liệt kê những điểm	
to listen with both ears	chú ý nghe	
to live a leisurely life	an dật	
to live alone	sống neo đơn	
to live at one’s in laws’	gửi rể	
to live in a state of	sống trong cảnh	
to live in peace	an cư lạc nghiệp	
to live in the U.S.	sống trên nước Mỹ	
to live together 100 years (set expression said to newlyweds)	bách niên giai lão	
to lobby congress	vận động quốc hội	
to long to day-dream	tơ tưởng	
to look after	coi sóc	
to look around (once)	nhìn một vòng chung quanh	
to look at	coi	
to look behind	nhìn lui	
to look down at the ground	nhìn xuống đất	
to look haggard	vẻ mặt bần thần	
to look surprised	có vẻ ngạc nhiên	
to loose weight	sọp	
to lose	bại	
to lose a battle	bị thất trận	
to lose face	bẽ	
to lose heart	sờn lòng	
to lose one’s name	bị xóa tên	
to lose one’s voice	mất tiếng	
to lose the throne	mất ngôi	
to love	thương yêu	
to lower the flag	hạ cờ	
to lump	à uôm	
to lurk	rình mò	
to make a down-payment	đặt cọc	
to make a light of	coi nhẹ	
to make a movie	làm điện ảnh	
to make a serious face	làm mặt nghiêm	
to make a slip of the tongue	lỡ mồm	
to make a wild guess	đoán mò	
to make bigger	vùn	
to make contact	bắt mối động từ	
to make fun of	cười chê	
to make mincemeat of somebody	ăn tươi nuốt sống	
to make narrow	hẹp lại	
to make progress	đạt tiến bộ	
to make somebody listen to reason	thuyết lý	
to make someone’s acquaintance	làm quen với ai	
to make up	ma ki ê	
to make us happy	cho mình vui lòng	
to manage	trị sự	
to mark a paper	phê điểm	
to market	tiếp thị	
to master (a subject)	rành	
to materialize	vật chất hóa	
to measure	lường	
to meddle in the internal affairs	can thiệp vào việc nội bộ	
to meet again	tái nhóm	
to meet with	gặp nhiều khó khăn	
to meet with the Pope himself	gặp chính Đức Giáo Hoàng	
to migrate to the United States	di cư sang Mỹ	
to miscalculate	vụng tính	
to miss one’s homeland	nhớ quê hương	
to mix (with)	tùng đảng	
to mock	riễu	
to modify	sửa đổi luật	
to mount a punitive expedition (against a smaller nation)	chinh phạt	
to move backwards	dội ngược ra sau	
to move one’s army forward	tiến binh	
to move towards	tiến thẳng tới	
to murmur	thỏ thẻ	
to negotiate (for peace)	hòa nghị	
to never stop talking	nói luôn miệng	
to nod	gật gưỡng	
to not (be able to) stand or bear sth	không chịu nổi	
to not allow	không để	
to not be hard at all	đâu có gì khó khăn	
to not be responsible for one’s actions	không tự chủ được hành động của mình	
to not dare to do	chẳng dám làm	
to not expect that	không ngờ rằng	
to not have	không có được	
to not have to know	không cần biết	
to not heed	bất cố	
to not know much	không biết nhiều	
to not mind (hardship)	bao quản	
to not say another word	không nói thêm một lời	
to not want	không thèm	
to nourish	bồi dưỡng	
to obey the imperial decree	phụng chỉ	
to obtain by seduction	ăn dỗ	
to occupy	hùng cứ	
to occur	sảy đến	
to offer advice	góp ý	
to offer marriage	dạm vợ	
to offer support	tình nguyện ủng hộ	
to only exist on paper	chỉ sống trên giấy tờ	
to open	bóc vỏ	
to open a conference	mở hội đàm	
to open a lid	mở nắp ra	
to open one’s mouth to ask	mở miệng hỏi	
to open the door to (something)	mở đường cho	
to oppose	kình chống	
to oppose or resist taxation	kháng thuế	
to order	hạ lịnh	
to order an investigation	ra lệnh điều tra	
to originate	phát nguyên	
to outline (sketch out) a plan	phác thảo một kế hoạch	
to overflow	tràn	
to overshoot	bay quá mục tiêu	
to overtake	qua mặt	
to overthrow the king	truất vua	
to pamper	cưng	
to pant	phì phò	
to park a car	đậu xe	
to participate	tham dự	
to pass a ball	chuyền bóng	
to pass an exam	thi đỗ	
to pass one’s old age peacefully	an hưởng tuổi già	
to pay a fee	đóng lệ phí	
to pay attention	lưu tâm	
to pay back	trang trải	
to pay by installments	trả góp	
to pay cash	giả tiền mặt	
to pay in gold	trả bằng vàng	
to pay taxes	đóng thuế	
to pay wages	trả lương	
to peel	bóc	
to penetrate	thâm nhập	
to perform	trình diễn	
to perform maneuvers	diễn tập	
to photograph	chụp ảnh	
to pick up a bad habit	mắc tật	
to pick up a fork	cầm nĩa lên	
to pin	ghim	
to piss oneself laughing	cười vãi đái	
to place an order (to buy something)	đặt mua	
to place in a difficult situation	đặt vào thế khó xử	
to plan	thiết kế	
to plant a tree	giồng cây	
to play a game	làm trò	
to play an active role	đóng vai trò tích cực	
to play on words	chơi chữ	
to play the hero	làm anh hùng	
to plead guilty	chịu tội	
to pledge or swear allegiance by drinking	uống máu ăn thề	
to poach (animals)	săn trộm	
to point a gun	chĩa súng	
to poke or stick or shove one’s finger into somebody’s face	xỉa xói	
to pollinate	thụ phấn	
to pose as	trá hiệu	
to pour out one’s inmost feelings	thổ lộ niềm tây	
to practice	tu luyện	
to practice nomadic farming	du canh	
to pray and do obeisances	khấn vái	
to pray for peace	kỳ yên	
to preach	rao giảng	
to predict by thumbing one’s phalanges	bấm độn	
to prepare for the worst	chuẩn bị cho trường hợp trắc trở	
to preserve one’s heritage	giữ gìn di sản	
to press (a button	nhấn đè	
to press the accelerator	nhấn ga	
to pretend	giả dạng	
to pretend to be weak	giả hèn	
to prize up a pillar	bẩy cột nhà	
to produce a film	đạo diễn phim	
to profit by others’ labor	ăn hớt	
to promote a program	xúc tiến chương trình	
to promulgate	tuyên truyền	
to prosper	phát đạt	
to prostrate oneself before an altar	cúi lạy trước bàn thờ	
to protect one another	che chở lẫn nhau	
to provide relief for (old or disabled person)	cấp dưỡng	
to publicize	công khai hóa	
to pucker one’s lips	cong vành môi lên	
to pull down	vít	
to pull out of	kéo ra khỏi	
to pull up	nhổ	
to punch	ục	
to punish someone for a crime	trừng phạt về tội	
to pursue a job	theo đuổi công việc	
to push a button	bấm nút	
to put a final stop to (a writing)	chấm hết	
to put aside	dẹp qua một bên	
to put by someone’s share	để phần	
to put in	lắp vào	
to put in the same category	đồng hóa	
to put it that way	nói như vậy thì	
to put out	thè	
to put someone at ease	làm người nào an lòng	
to puzzle one's brains	nghĩ nát óc	
to quit	bỏ cuộc	
to quote (sb’s words)	trích lời	
to race	chạy thi	
to rack	tra tấn	
to raise a banner	giơ cao biểu ngữ	
to raise one’s glass (in a toast)	nâng ly	
to raise one’s voice	hất hàm	
to raise one’s voice in denunciation	lên tiến tố cáo	
to raise the rent	tăng tiền thuê	
to rake one’s brain	nạo óc	
to ransom	chuộc mạng	
to reach a peak	lên tột đinh	
to reach marrying age	cập kê	
to react strongly	phản ứng mạnh mẻ	
to read over someone’s shoulder	đọc ké	
to reappear	lại hiện lên	
to reason	suy luận	
to recede	đi vào dĩ vãng	
to receive (and listen to)	đón nghe	
to receive a gift (from someone above oneself)	bái lĩnh	
to receive approval	nhận sự tán đồng	
to receive permission	nhận giấy phép	
to recognize	công nhận	
to recognize the independence of VN	nhìn nhận nền độc lập của Vietnamese	
to reconsider	xem xét lại	
to record	ghi	
to recount	phản ánh	
to recover (from an illness)	bình phục	
to recover from an illness	khỏi bệnh	
to rectify (a curve)	cầu trường	
to reduce	giảm chi phí	
to reek of alcohol	phà hơi sặc mùi rượu	
to reestablish	lập lại	
to reflect	nghiền ngẫm	
to refract	khúc xạ	
to refuse	bác lời	
to regain	giành lại	
to register	vào sổ	
to regret one’s effort	tiếc công	
to reign	ngự trị	
to release from jail	ra tù	
to rely on one’s nobility	hiệp quí	
to rely on one’s power	hiệp thế	
to remain in patient silence	nín thít	
to remember	nhớ đến	
to remember vaguely	bập bõm	
to remotely control	thực hiện điều khiển từ xa	
to rent	thuê mướn	
to repair	hàn gắn	
to repeat	láy	
to repeat from the beginning	nhắc lại từ đầu	
to replace	thay thế	
to report (clearly)	tường trình	
to report anonymously	ẩn danh cho biết	
to reprint	tái bản	
to request a deferral	khất nợ	
to rescue	cứu giải	
to resettle	tái định cư	
to resign (from office)	từ chức	
to resign oneself to one’s fate	cam phận	
to resound faintly	vẳng	
to respect	kinh trọng	
to respond	ứng	
to respond to an appeal	đáp ứng lời kêu gọi	
to rest	an tức	
to restore a cease-fire	đem lại một cuộc ngưng bán	
to restrain one’s passions and desires	chế dục	
to retell a story	kể lại chuyện	
to retract one’s statement	phản cung	
to return (something to someone)	trao lại	
to return to a happy life	trở về an cư	
to review	tham khảo	
to revive the past	phục cổ	
to reward oneself	tự thưởng	
to ring out	nổ vang	
to rinse dishes	tráng chén	
to rise (into a position)	vươn mình	
to rise suddenly in rank or status	vượt cấp	
to risk	thí	
to rob	bốc lột	
to rob a bank	cướp một nhà băng	
to rotate	luân chuyển	
to rub one’s eyes	dụi mắt	
to rule the earth	cai quản trái đất	
to rumble	lịch kịch	
to run across	chạy ngang	
to run backwards	chạy lui	
to run home	chạy về nhà	
to run into a lot of things	gặp toàn những chuyện	
to run into debt	gây nợ	
to run off the line	trật bánh	
to run towards	chạy gần	
to run with short steps	lon ton	
to rush out	nhảy tới	
to sacrifice	bán lỗ	
to sacrifice oneself	hi sinh	
to satisfy customers	chiều lòng khách hàng	
to sauté	áp chảo	
to save money	để sành tiền	
to save one’s soul	cứu vớt linh hồn	
to say	nói ra	
to say clearly	nói rõ	
to say to much	quá đáng	
to scoff	cười khỉnh	
to scream hysterically	hét nhặng xị	
to scribble	tháu	
to search one’s pockets	lục túi	
to see a prospective bride (or a prospective groom) before	xem mặt	
to see off	tống biệt	
to see to (something)	mưu sự	
to seek comfort in religion	tìm sự an ủi ở tôn giáo	
to seek information	dò hỏi	
to seize property	chiếm đoạt tài sản	
to sell for cash	bán tiền mặt	
to sell well	bán chạy	
to send a card	gởi thiệp	
to send a message to	nhắn	
to send forth	xuất phát	
to send on a special mission	đặc phái	
to separate	chia cắt	
to separate from	tách khỏi	
to set	tu tạo	
to set one’s foot down	đặt chân xuống	
to set up headquarters	đặt trụ sở	
to sever	cắt đứt liên hệ	
to shame	bêu xấu	
to share common goals	chia sẻ mục tiêu chung	
to sharpen	vót	
to shed tears	rơi lệ	
to shiver	lật bật	
to shoot back	bắn lại	
to shoot the moon	trốn nợ	
to shop	mua bán	
to shoulder one’s share of responsibility for	ghé vai	
to shout (in fear	la hoảng	
to shovel dirt	xúc đất	
to show movies	chớp bóng	
to show support	bày tỏ sự hậu thuẫn	
to shriek	hét	
to shrug indifferently	nhún vai lạnh lùng	
to shuffle the cards	trộn bài	
to sigh	thở dài	
to simplify	giản dị hóa	
to sink	chìm lỉm	
to sink down	chìm sâu xuống	
to sit (down) at a table	ngồi vào bàn	
to sit around a table	ngồi xung quanh bàn	
to sit cross-legged	bắt chân chữ ngũ	
to sit next to	ngồi bên cạnh	
to sit on sb’s lap	ngồi lên đùi	
to sit up straight	ngồi thẳng người	
to skid	pa ti nê	
to slander	vu cáo	
to slap one's hands together	vỗ hai tay vào nhau	
to sleep an endless sleep	an giấc nghìn thu	
to sleep like a log	ngủ khì	
to slip	sỉa	
to slip away	chuồn	
to slow down	chậm lại	
to smear one’s parents’ name	nhơ danh cha mẹ	
to smell (badly)	hôi như cú	
to smell strong or nasty or rancid	trở mùi	
to smile and show one’s teeth	cười nhe răng	
to smoke out	hun khói	
to smooth out	bình ổn	
to snap	bật	
to sneeze because of a cold	bị cảm nhảy mũi	
to soak	ngâm	
to soil	đánh bẩn	
to speak by mistake	nói lầm	
to speak frankly	nói thẳng	
to speak ill of	báng (1) butt	
to speak in more general terms	nói rộng hơn	
to speak on and on	nói thao thao	
to speak up frankly	bộc bạch	
to specialize	chuyên hóa	
to spend (money)	tiêu	
to spend the night at somebody’s house	ngủ nhờ	
to spin thread	se chỉ	
to spit fire	tóe lửa ra	
to split one’s sides (with laughter)	ngặt nghẽo	
to sponsor	đỡ đầu	
to spread like (wild)fire	lan tràn như đám cháy	
to spread or radiate heat	tỏa nhiệt	
to spring upon a victim	vồ lấy nạn nhân	
to spy on	rình thấy	
to squeeze	bấu xén	
to stab to death	đâm chết	
to stabilize an economy	ổn định nền kinh tế	
to stagger	khất khưởng	
to stain	nhọ	
to stand	đưng	
to stand behind someone	đứng sau lưng	
to stand looking bewildered in the streets	đứng nghếch ở giữa phố	
to stand stupified	đứng đực	
to stare	soi mói	
to stare at someone	nhìn trừng trừng	
to start a conversation	gợi chuyện	
to start work	bắt tay vào việc	
to state	ghi nhận	
to stay in power	duy trì quyền hành	
to steer	bẻ lái khẩu ngữ	
to step back	lùi bước	
to step inside	bước vào trong	
to stick out	nhô ra	
to stick to tradition	nệ cổ	
to still exist up to the present day	vẫn còn tồn tại cho tới ngày nay	
to still have time	còn thì giờ	
to stir	quấy	
to stop	hảm	
to stop crying	nín khóc	
to stop putting up with	hết chịu nổi	
to stop walking	dừng bước	
to straddle	chạng háng	
to strengthen	bồi đắp	
to stretch one’s neck	nghển cổ	
to strike a friendship	kết bạn	
to strike through	gạch	
to strive to reach the shore	cố nhoai vào bờ	
to stroll	thẩn thơ	
to struggle with one’s conscience	đấu tranh tư tưởng	
to study positions and aspects of celestial bodies in	chiêm tinh	
to study very hard	học rất chăm	
to subcontract	thầu lại	
to submit a job application	đệ đơn xin việc	
to suffer	khổ thân	
to suffer a loss	thua thiệt	
to suffer smoke inhalation	bị ngộp khói	
to sum up	tóm lấy	
to supply oneself	tự cấp	
to suppose	giả sử	
to surrender to the police	đầu hàng cảnh sát	
to swallow	nuốt	
to swallow an insult	nhịn nhục	
to swarm	lâu nhâu	
to swell (outwards)	phình ra	
to swell up	bùng dậy	
to swim on one’s back	bơi ngửa	
to switch	bẻ ghi	
to take (to)	mê mải	
to take a bath	tắm táp	
to take a land route	đi đường bộ	
to take a mock exam	thi thử	
to take a shower	tắm một cái	
to take about 2 days	mất độ hai ngày	
to take care of oneself	nuôi thân	
to take off one’s clothes	cởi quần áo	
to take or swear an oath	phát thệ	
to take out taxes	trừ thuế	
to take part	vào cuộc	
to take part in an imperial banquet	ăn yến	
to take responsibility	nhận trách nhiệm	
to take someone (to a place)	đưa sang	
to take something out of one’s pocket	móc túi	
to take up a firing position	lấy thế bắn	
to talk a lot	nói nhiều	
to talk dirty	nói tục tỉu	
to talk incessantly	luôn miệng	
to talk only of absurd things	nói toàn những chuyện ngang tai	
to talk to each other	nói với nhau	
to tax	trách	
to teach (school)	dạy học	
to teach and bring up	giáo dưỡng	
to tear to pieces	đánh tơi tả	
to tease mischievously	đùa cợt	
to televise live	trực tiếp truyền hình	
to tell a joke	nói một lời pha trò	
to test or try the strength of	thử sức	
to thank respectfully	bái tạ	
to the extent (that)	đến độ	
to think about	suy nghĩ về	
to think of a plan	nghĩ ra một kế hoạch	
to think twice about speaking	giữ mồm giữ miệng	
to thirst after honors	hiếu danh	
to thread	xâu	
to threaten directly	đe dọa trực tiếp	
to thrive	ăn nên làm ra	
to throw (away)	vứt	
to throw a grenade	ném lựu đạn	
to throw about	rải tung	
to throw into	quăng vào	
to throw oneself on the ground	vật vã	
to throw out	bắn tung	
to throw up	nôn	
to tie	cột chặt	
to tolerate	dung	
to torment	giày vò	
to toss	trằn trọc	
to train	tập tành	
to transcribe	biên chép	
to translate	biên dịch	
to translate from English into Vietnamese	dịch từ tiếng anh ra tiếng việt	
to translate into Vietnamese	chuyển sang Việt ngữ	
to transmit data	truyền dữ liệu	
to trap	làm bẫy	
to treat	điều trị	
to treat with every possible means (a seriously ill person)	chạy chữa	
to tremble with fear	run lên bần bật	
to try to sleep	tìm giấc ngủ	
to turn	ngoẹo	
to turn (oneself) around	quay người lại	
to turn a completely blind eye to life	phớt đời	
to turn around and go back in	quay trở vào	
to turn back	quay lui	
to turn into	quẹo vào	
to turn off an engine	tắt máy	
to turn the key another click	vặn chìa khóa một nấc nữa	
to turn to the left	rẽ tay trái	
to twist the face	mếu	
to underestimate	khinh thường	
to understand and love	bén duyên	
to unify a country	thống nhất đất nước	
to unmask	lật tẩy	
to unravel	gỡ	
to urbanize	đô thị hóa	
to urinate and defecate	ỉa đái	
to use casuistry	lý sự	
to use one’s influence with someone	phát huy ảnh hưởng (của mình) đối với ai	
to use strong words	nặng lời	
to value something highly	đánh giá cao	
to venerate	sùng kính tổ tiên	
to vie with	đọ tài với	
to violate an agreement	vi phạm thỏa ước	
to voice	lên tiếng cáo buộc	
to vouch for	làm chứng cho	
to wage guerrilla warfare	đánh du kích	
to wait a moment	chờ chút	
to wait for the moment (when)	chờ đến cái lúc	
to walk around (once)	đi một vòng	
to walk on stilts	đi cà kheo	
to walk outside	bước ra cửa	
to walk with crutches	đi bằng nạng	
to wander (aimlessly)	lang thang	
to want	thèm muốn	
to warn about	cảnh báo về	
to wash one’s face	rửa mặt	
to waste	uổng phí	
to waste time with	phí thì giờ với	
to water	tưới nước	
to wave	phất	
to wean (from breastfeeding)	thôi bú	
to wear a bra	mặc xú chiêng	
to wear a tie	thắt ca vát	
to wear down	làm nhụt	
to wear on one’s chest	đeo trên ngực	
to wear one’s clothes in disarray	quần áo treo bừa bãi	
to weigh	cân kẹo	
to weigh many issues	cân nhắc nhiều vấn đề	
to welcome (a guest)	nghênh tân	
to wet oneself	vải đái	
to whisper in someone’s ear	thì thầm vào tai	
to widen one’s perspectives	mở rộng tầm mắt	
to win a bet	ăn cuộc	
to win a lottery	trúng số	
to win the hearts	thu phục	
to wind about	ngoằn ngèo	
to wipe	lau	
to wipe one’s mouth	chùi miệng	
to wish respectfully	kính chúc	
to withdraw	rút lại	
to work all day	làm việc suốt ngày	
to work as an engineer	làm kỹ sư	
to work one’s way	len lõi	
to work the bellows and blow on the fire	kéo bễ thổi lò	
to wound	đả thương	
to wrinkle one’s eyebrows	nhíu may	
to write	viết lách	
to writhe in pain	đau quặn	
to yell and cry	gào khóc	
toad	thiềm thừ	
today	trong ngày hôm nay	
today year	ngày rày	
together with	chung với	
toilet water	nước bồn cầu	
told me right away	cho tôi biết ngay	
tollbooth (on a turnpike)	trạm mãi lộ	
tomonetre	nhãn áp kế	
tomorrow morning	sáng mai	
tongue	mồm mép	
tonics	bổ dược	
too lengthy	nhai nhải	
too marvelous	kỳ tuyệt	
tool	dụng cụ	
tooth	cái răng	
toothpaste	kem đánh răng	
topographical map	bản đồ địa hình	
topsy-turvy	bát nháo	
torpedo	ngư lôi	
tortoise	con ba	
toss and turn	giằn giọc	
total cost	giá tiền tổng cộng	
touch out of curiosity	tần mần	
tough	cứng nhẳng	
tourniquet	ga rô	
towboat	tàu giòng	
toweringly tall	cao ngồng	
toxic drug	độc dược	
trace	dấu vết	
track roller	bánh lăn đỡ	
tractor (-drawn) plough	cày máy	
trade agreement	hiệp ước thương mại	
trader	thương nhân	
traditional	truyền thống	
traditional song (originated in the central regions)	nam bằng	
traffic police	cảnh sát giao thông	
training center	trung tâm đào tạo	
tranquilizer	thuốc an thần	
transform equation	phương trình biến đổi	
transformer	máy biến áp	
transition period	thời gian chuyển tiếp	
transmit through	truyền qua	
transport	đài tải	
trapezium	hình thang	
travel back and forth	vãng phản	
traveler’s notes	du ký	
tray	khay	
treasury	công khố	
treat well	trọng đãi	
tree root	rễ cây	
trefoil	nhép	
trepang	hải sâm	
tribe	bộ lạc	
trick	mánh lới	
trifle	tri thù	
trinity	ba ngôi	
triumphal arch	khải hoàn môn	
troop unit	binh đoàn	
troposphere (meteor)	tầng đối lưu	
truck	xe cam nhông	
truly	quả là	
trust	tín nhiệm	
tube	ống tuýp	
tuition fees	học phí	
tumble down in a genuflexion	sụp lạy	
tumor-causing	sinh khối u	
tundra	đài nguyên	
tuner (television	bộ điều hưởng	
tunnel	hầm ngầm	
turn back	ngảnh lại	
turn in another direction	ngoảnh đi	
turn over a new leaf	hoán cải	
turnkey	chìa khóa trao tay	
turquoise	xanh lam	
twin	cặp đôi	
two decades ago	từ trước đây hai thập niên	
two years ago	cách đây hai năm	
two-legged	hai cân	
two-way	hai chiều	
type of satirical poem phrase or proverb	yết hậu	
typesetting	việc xếp chữ	
typhoon	bão nước	
U.S. authorities	giới chức Mỹ	
ultimatum	chiến thư	
ultrabasic	cực kiềm	
unable (to do something)	không đủ sức	
unacceptably tasteless	nhạt như nước ốc	
unbaked brick	gạch mộc	
unceasingly	liền tù tì	
unclear	không rõ	
unconscious	bí tỉ	
uncovered	không mui	
undeniable	không thể chối cãi	
under communism	dưới chế độ cộng sản	
under the sun	dưới ánh mặt trời	
underdeveloped	bán khai	
underground water	nước ngầm	
underpinning	đá trụ	
understand the meaning	vỡ nghĩa	
undesirable element	thành phần bất hảo	
undutiful	thất hiếu	
unemployment insurance	bảo hiểm thất nghiệp	
unending joy	niềm vui bất tận	
unequal	bắt bình đẳng	
unexpected misfortune	tai bay vạ gió	
unfeeling	gan sành dạ sỏi	
unfinished uncompleted	dở dang	
unhappy face	sa sầm	
unhappy situation	bối cảnh bất bình	
uniform	chế phục	
uninflected language	ngôn ngữ không bị biến âm	
uninsulated electric wire	dây trần	
union dues	công đoàn phí	
United Nations	Liên Hiệp Quốc	
universal concept	phổ niệm	
university graduate	học sĩ	
unjustified	không có lý do	
unlike	chẳng bù	
unmanned	không người	
unmarried	chưa lập gia đình	
unnoticeably shallow	choèn	
unpardonable	bất dung	
unpleasant to the ear	chối tai	
unprecedented	vô tiền khoáng hậu	
unprincipled	vô hạnh	
unrighteous	bất chính	
unstable	không ổn định	
unsucessful	lận đận	
untidy	bù xú	
until afternoon	cho tới chiều	
until morning	cho đến sáng	
until that moment	cho đến lúc đó	
until the time when	cho tới khi	
unusual	lạ thường	
up to that point	đến lúc đó	
up until the year ~	cho tới năm	
upon leaving	lúc chia tay	
upper abdomen	bụng trên	
uprooted	trốc gốc	
upset	hầm hầm	
upside down	lộn bậy	
upstream	ngược dòng	
Uranus	thiên vương tinh	
urgency	sự hối thúc	
urgent and important	khẩn yếu	
US government bonds	trái phiếu chính phủ Mỹ	
use as pretext	mượn cớ	
useful	có ích	
useless	có cũng như không	
user name	tên người dùng	
USIS	Sở Thông Tin Hoa Kỳ	
usual	bình nhật	
utilitarianism	chủ nghĩa công lợi	
utter	buông lời	
vacation	vé du lịch	
vain	hoài công	
valiant	kiêu hùng	
value	giá trị	
valve	xú páp	
Van Allen belt	vòng đai Van Allen	
vantage ground	địa lợi	
variety actress	cầm đài	
variety of white canarium	trám trắng	
various good	tạp hóa	
vasodilatation	giãn mạch	
vast	thênh thênh	
vaulted	khòm khòm	
vector diagram	đồ thị véc tơ	
vegetation	cỏ cây	
vein	tĩnh mạch	
venerable brother	huynh ông	
venereal disease	bệnh tình	
venom	nọc	
verdgris	ten	
verifiable	có thể kiểm chứng	
vermicelli and beef	bún bò	
vertebra	đốt sống	
very bitter	đắng nghét	
very clean	sạch bách	
very cold	cực hàn	
very deep	hoáy	
very elaborate	đại công phu	
very fast	băng băng	
very flat	xép xẹp	
very good and gentle	hiền khô	
very happy	mừng lắm	
very inexpensive	rẻ mạt	
very little	ít ỏi	
very mild	êm ru	
very pale	xanh xao	
very profound	sâu thẳm	
very reliable	tâm phúc	
very shiny	bóng lộn	
very slimy	nhớt nhợt	
very sorry	rất tiếc	
very sweet-very tasty	ngọt lịm	
Very thin clothes	quần áo mỏng manh	
very tight	thật chặt	
very wealthy person	đại phú	
very yellow	vàng ệnh	
veteran	cựu binh sĩ	
vicar	cha sở	
vice president (of society)	phó hội trưởng	
vicissitudes	hưng suy	
victory or defeat	thắng bại	
Vientiane	Vạn Tượng	
Vietnam Bank For Agriculture	Ngân Hàng Nông Nghiệp	
Vietnamese	Việt	
Vietnamese chord zither	đàn thập lục	
Vietnamese community	cộng đồng Việt Nam	
Vietnamese language	Việt ngữ	
Vietnamese News Agency	Thông Tấn Xã Việt Nam	
Vietnamese salad with fresh vegetables	gỏi	
vigilant	cảnh giác	
vile	đê mạt	
village (inhabitants)	làng nước	
village chief	hương trưởng	
village elder	bô lão	
village inhabitant	dân đinh	
village patriarch	già làng	
village registrar	hương bộ	
village’s young men’s register	đinh bạ	
vinegar	dấm	
violent	kịch liệt	
violent or abusive toward women	vũ phu	
violin	vi ô lông	
virgin forest	rừng nguyên thủy	
virtual	thực tại ảo	
virtual memory	bộ nhớ ảo	
virus	siêu vi trùng	
visible	nổi cộm	
vitality	hoạt lực	
vocal music	nhạc hát	
vocational training center	trung tâm huấn nghệ	
Voice of America	Tiếng Nói Hoa Kỳ	
voltage control	điều khiển điện áp	
voltage fluctuations	dao động điện áp	
vomer	lá mía	
voodoo	tà thuật	
vulgar person	phàm phu	
wages	công sá	
wait (for someone) in front (to stop his advance)	đón đầu	
waitress	cô hầu bàn	
walkie-talkie	máy bộ đàm	
wampee	hồng bì	
wanton	đĩ thõa	
war situation	binh thế	
warehouse-book	sổ kho	
warm feeling	cảm giác âm ấm	
warmly clothed	ấm cật	
wart	mụn cóc	
was divided into 2 groups	đã chia làm 2 phe	
wash and iron	giặt là	
wasp	ong vàng	
waste land	bãi đất hoang	
waste water	nước thải	
wasteful	xài phí	
waste-paper	giấy vụn	
watch tower gazebo	vọng lâu	
watch-night time	giao thừa	
water	thủy	
water hyacinth	bèo hoa dâu	
water off a duck’s back	nước đổ đầu vịt	
water puppetry	rối nước	
watering-cart	xe tưới đường	
water-nymph	thủy thần	
water-rail	đỗ quyên	
wattmeter	oát kế	
waves of people	làn sóng người	
way	nẻo đường	
way of speaking	cách dùng chữ	
way up hill and down dale	dặm ngàn	
we have gone too far to draw back now	cưỡi hổ	
weak and intermittent	nhấp nhem	
weakly	òi ọp	
weary	mỏi	
web paper	giấy súc	
wedding-day	ngày vu qui	
Wednesday	hôm thứ tư	
weeping scabies	ghẻ nước	
weight	gánh nặng	
well	bằng an	
well-behaved	ngoan ngoãn	
well-matched	phải lứa	
well-proportioned	chằn chặn	
western calendar	tây lịch	
western medicine	thuốc tây	
wet (clothes)	ướt nhè	
wet with tears	rơm rớm	
wharf	bến cảng	
what a pity !	tiếc thay	
what could be better than ~	còn gì bằng	
what date?	mấy tây	
what else	tới cái gì nữa	
what happened today	chuyện ngày hôm nay	
what is it	chuyện gì vậy	
what price that thing?	báu gì cái của ấy?	
what time is it (now)	bây giờ mấy giờ rồi	
What was his reaction?	phản ứng của ông thế nào	
whatever	ngững gì	
whatever the case may maybe	dẫu thế nào	
when asked about the article	khi được hỏi về bài báo	
when fortune smiles upon you	khi nên	
when one was young	hồi nhỏ	
When three know	một miệng thì kín	
when your neighbor suffers	môi hở răng lạnh	
where (I wonder)?	đâu nhỉ	
where did ... escape to?	trốn đi đâu nhỉ	
whether possible or not	thế không thể	
whether rich or poor	dù giàu hay nghèo	
which bound volume	cuốn nào	
which day	ngày nào	
which direction	hướng nào	
which is called	gọi tắt là	
which person	người nào	
which time	lần nào	
while	giữa lúc	
whining	dấm dứt	
whistle	tu huýt	
white	màu trắng	
white bass	cá bống mú	
white cabbage	cải trắng	
white collar workers	dân thầy	
white flag	cờ trắng	
white headed	đầu róc bạc phơ	
white horse	ngựa bạch	
white lead	bạch diên	
white mourning head-band	khăn trắng	
White Russian	Bạch Nga	
white soul	hồn bạch	
who else could it be?	chớ ai nữa	
who is there?	ai đó?	
who’s the man standing over there?	người đứng ở đằng kia là ai vậy?	
whole	toàn bộ	
wholeheartedly	tận tình	
whole-heartedly	một lòng	
whose?	của ai	
why	bởi sao	
why (is that)?	sao vậy	
why are you waiting for me?	chờ tôi làm gì	
why is that	tại sao vậy	
why! well!	ô hay	
wide area network	mạng toàn cục	
wide open	chành bành	
widow	góa bụa	
widowed	bụa	
wife	con vợ	
wife and children	thê tử	
wife of one’s grandson-wife of one’s nephew	cháu dâu	
wife’s father	bố vợ	
wild	dã	
wild beast	thú dữ	
wild cat	mèo rừng	
wild goose	nhạn	
will have to	sẽ phải	
will see	sẽ hay	
wily	đa mưu	
win a prize as a challenger	phá giải	
wind and waves	sóng gió	
winding	co quanh	
winding configuration	tổ đấu dây	
window	cánh cửa sổ	
window curtain	màn cửa sổ	
window glass	kính của sổ	
wine	rượu chát	
wine and women	tửu sắc	
wine gourd	bầu rượu	
wink	nhấm nháy	
winkle out	nhể	
winkled	dăn dúm	
winnover	quạt hòm	
wiping cloth	khăn lau	
wise	khôn	
wise administration	thiện chính	
wise person	hiền giả	
witchcraft	đồng cốt	
with	đối với	
with anyone at all	với ai hết	
with difficulty	ì à ì ạch	
with disheveled or tousled or unkempt hair	đầu bù tóc rối	
with each breath	theo từng hơi thở	
with extreme slowness	dẫn rượu	
with interest	lẫn lời	
with pain	oai phong	
with pomp and ceremony	nghi vệ	
with regards to	về phương diện	
with the argument that	với lập luận là	
with the idea that	với ý nghĩ là	
withered	dàu dàu	
within	trong nội địa Hoa Kỳ	
within a few minutes	trong vòng vài phút đồng hồ	
within a week	trong vòng một tuần	
within the party	nội bộ đảng	
without a moment’s hesitation	không một chút do dự	
without any news	tuyệt vô âm tín	
without security	bất an	
witness	chứng nhân	
wok	chảo	
wolfram	uôn pham	
woman	phụ nữ	
woman artist	nữ nghệ sĩ	
women	quần hồng	
women of beauty and men of talent	trai tài gái sắc	
women’s European-style trousers	quần phăng	
women’s rights	nữ quyền	
won ton	vằn thắn	
won’t be like that anymore	sẽ không như thế nữa	
wood	gỗ	
woodcock	dẽ gà	
wooden shed	chòi gỗ	
wooden shoe	guốc	
woodman	sơn tràng	
wood-sorrel	chua me đất	
word used to express mild disagreement	ứ ừ	
words of greeting	lời chào	
worker’s union	nghiệp đoàn công nhân	
workers	thợ thuyền	
working class	giai cấp cần lao	
working conditions	điều kiện làm việc	
World Bank	Ngân Hàng Thế Giới	
World Health Organization	Tổ Chức Y Tế Thế Giới	
world outlook	thế giới quan	
World Wide Web (WWW)	mạng lưới giao liên toàn cầu	
worldly matters or things	sự đời	
worldly suffering	tục lụy	
worldly-wise	lọc lõi	
worldwide	trên thế giới	
worm	giun	
worm wheel	bánh xe có ốc vô tận	
worn out	cà tàng	
worn-out	rã người	
worried	khắc khoải	
worrisome	lao tâm	
worsen	suy tổn	
worship	việc thờ phượng	
worth	trị giá	
would it be easy to	há dể	
wounded soldier	thương binh	
wrap in grass and bury	kiểu táng	
wrapper	giấy bọc	
wrestler	đô vật	
wriggle	ngọ ngoạy	
wrinkled skin	da mồi	
wrist-watch	đồng hồ đeo tay	
writer	bỉnh bút	
writing system	chữ viết	
written	thành văn	
written examination	thi viết	
written from a man’s perspective	viết theo kiểu đàn ông	
xenophile	thân ngoại	
xenophobia	sự bài ngoại	
X-ray	chiếu điện	
yamen	huyện nha	
yard	sân	
year	niên	
year (of one’s life)	năm tuổi	
years in a row	năm kế tiếp	
years of age	tuổi đầu	
yeast	nấm men	
yell	nhí nhéo	
yellow and black-ringed krait	rắn cạp nong	
yellow fever	bệnh sốt vàng da	
yellow-colored rice cake	su sẽ	
yellowish	vàng vàng	
Yen (Japanese currency)	đồng Yen	
yesterday	hôm qua	
yield	huê lợi	
yolk (of an egg)	tròng đỏ	
you (esteemed person)	quý vị	
you (familiar plural)	các bạn	
you (used by a superior to an inferior)	mày	
young and beautiful	trẻ đẹp	
young and fresh	mơn mởn	
young and old (alike)	nam phụ lão ấu	
young king	thiếu quân	
young man	anh thanh niên	
young peach	đào non	
young people	bọn trẻ	
young servant	hề đồng	
younger brother	bào đệ	
younger son	á tử	
your (precious) family	bảo quyến	
your daughter	lệnh ái	
your elder brother	lệnh huynh	
your humble servant (a woman speaking to her husband)	tiện thiếp	
your royal highness	điện hạ	
your stupid little brother	ngu đệ	
youth is full of zeal	thanh niên đầy nhiệt huyết	
zealous	sốt sắng	
zenith	thiên đỉnh	
zephyr	gió may	
zero sequence	thứ tự không	
zoo	sở thú	
zoological and botanical garden	thảo cầm viên	
Zoroastrianism	Bái hỏa giáo	
he	anh ấy
a big guy	một gã to con
